"INSEE_COM","Annee","Nb_mutations","NbMaisons","NbApparts","propmaison","propappart","PrixMoyen","Prixm2Moyen","SurfaceMoy"
"33001","2020",15,15,0,100,0,160000,"1804.4",93
"33002","2020",17,17,0,100,0,"211864.705882353","1701.76470588235","134.352941176471"
"33003","2020",161,139,22,"86.3354037267081","13.6645962732919","230421.211180124","2511.70807453416","95.5341614906832"
"33004","2020",23,22,1,"95.6521739130435","4.34782608695652","188291.304347826","2288.82608695652","86.6521739130435"
"33005","2020",256,198,58,"77.34375","22.65625","399849.234375","4865.2734375","88.16015625"
"33006","2020",14,14,0,100,0,"133771.428571429","1398.28571428571","103.642857142857"
"33007","2020",17,17,0,100,0,"290190.470588235","2495.35294117647","117.294117647059"
"33008","2020",3,3,0,100,0,134000,1214,109
"33009","2020",563,168,395,"29.8401420959147","70.1598579040853","469947.957371226","6984.37655417407","68.1829484902309"
"33010","2020",9,9,0,100,0,"203728.333333333","2163.33333333333","93.2222222222222"
"33011","2020",159,121,38,"76.1006289308176","23.8993710691824","333357.427672956","4224.3144654088","81.6100628930818"
"33012","2020",42,41,1,"97.6190476190476","2.38095238095238","337255.595238095","2994.38095238095","115.738095238095"
"33013","2020",79,61,18,"77.2151898734177","22.7848101265823","311850.493670886",3407,"95.7721518987342"
"33014","2020",15,15,0,100,0,"239682.333333333","1794.46666666667","132.533333333333"
"33015","2020",17,16,1,"94.1176470588235","5.88235294117647","264733.529411765","2690.52941176471",105
"33016","2020",6,6,0,100,0,"299141.666666667","2069.33333333333",154
"33017","2020",5,5,0,100,0,162760,"1898.8","91.6"
"33018","2020",38,35,3,"92.1052631578947","7.89473684210526","201965.5","2137.81578947368","101.5"
"33019","2020",152,111,41,"73.0263157894737","26.9736842105263","283066.046052632","3208.69078947368","89.2039473684211"
"33021","2020",12,12,0,100,0,"159080.833333333","1672.41666666667","95.25"
"33022","2020",41,41,0,100,0,"254928.658536585",2588,"102.707317073171"
"33023","2020",6,6,0,100,0,236100,"2195.83333333333","112.5"
"33024","2020",7,7,0,100,0,"183657.142857143","1379.71428571429",137
"33025","2020",3,3,0,100,0,"200966.666666667","1802.66666666667","118.333333333333"
"33026","2020",10,10,0,100,0,"218331.9","1775.6",124
"33027","2020",3,3,0,100,0,"222666.666666667","1441.66666666667",155
"33028","2020",13,13,0,100,0,"285606.153846154","2481.30769230769","120.846153846154"
"33029","2020",67,55,12,"82.089552238806","17.910447761194","265193.850746269","2835.91044776119","96.8059701492537"
"33030","2020",29,24,5,"82.7586206896552","17.2413793103448","254014.586206897","2395.03448275862","104.620689655172"
"33031","2020",4,4,0,100,0,181875,1856,"103.5"
"33032","2020",61,51,10,"83.6065573770492","16.3934426229508","228173.278688525","2955.01639344262","81.344262295082"
"33033","2020",11,11,0,100,0,"354935.818181818","3163.09090909091","114.818181818182"
"33034","2020",7,7,0,100,0,"138049.285714286","1010.57142857143",127
"33035","2020",10,10,0,100,0,192080,"1497.7","135.1"
"33036","2020",59,54,5,"91.5254237288136","8.47457627118644","175657.694915254","1793.71186440678","103.152542372881"
"33037","2020",20,18,2,90,10,"280322.5","3022.95","92.9"
"33038","2020",15,15,0,100,0,"164112.8","1557.46666666667","103.333333333333"
"33039","2020",403,197,206,"48.8833746898263","51.1166253101737","279309.53101737","3847.66004962779","73.439205955335"
"33040","2020",15,15,0,100,0,"179190.533333333","2059.73333333333","93.6666666666667"
"33042","2020",93,88,5,"94.6236559139785","5.37634408602151","270402.76344086","2543.05376344086","109.225806451613"
"33043","2020",1,1,0,100,0,237500,1979,120
"33044","2020",5,5,0,100,0,"253250.2","1850.4","144.4"
"33045","2020",5,5,0,100,0,186020,"1690.6","121.6"
"33046","2020",12,11,1,"91.6666666666667","8.33333333333333","157333.333333333","1697.83333333333","98.3333333333333"
"33047","2020",22,22,0,100,0,"181695.454545455","1636.36363636364","116.409090909091"
"33048","2020",2,2,0,100,0,168500,"2370.5",74
"33049","2020",24,24,0,100,0,"283328.75","2709.83333333333","105.916666666667"
"33050","2020",8,8,0,100,0,219290,"1758.75","130.5"
"33051","2020",156,122,34,"78.2051282051282","21.7948717948718","265053.134615385","3079.58333333333",89
"33052","2020",30,13,17,"43.3333333333333","56.6666666666667","152424.333333333","2035.56666666667","72.3"
"33053","2020",4,4,0,100,0,"190962.5","1599.25",122
"33054","2020",6,6,0,100,0,"171998.333333333","1457.66666666667",126
"33055","2020",2,2,0,100,0,218525,"1744.5",123
"33056","2020",161,112,49,"69.5652173913043","30.4347826086957","295919.819875776","3218.8198757764","95.2298136645963"
"33057","2020",17,17,0,100,0,"218374.411764706","1593.76470588235","135.588235294118"
"33058","2020",109,89,20,"81.651376146789","18.348623853211","122197.266055046","1390.53211009174","87.1467889908257"
"33059","2020",6,5,1,"83.3333333333333","16.6666666666667",160750,1729,"88.1666666666667"
"33060","2020",1,1,0,100,0,177500,2399,74
"33061","2020",7,7,0,100,0,"287785.714285714",2618,114
"33062","2020",9,9,0,100,0,"197789.444444444","1436.44444444444","133.444444444444"
"33063","2020",4690,1277,3413,"27.228144989339","72.771855010661","330927.800426439","4756.65245202559","71.1411513859275"
"33064","2020",1,1,0,100,0,107000,1783,60
"33065","2020",41,39,2,"95.1219512195122","4.8780487804878","503158.341463415","4231.68292682927","126.146341463415"
"33066","2020",4,4,0,100,0,223000,1624,"140.75"
"33067","2020",35,35,0,100,0,"142327.085714286","1686.31428571429","85.2857142857143"
"33068","2020",3,3,0,100,0,"227333.333333333","2137.66666666667",112
"33069","2020",433,228,205,"52.6558891454965","47.3441108545035","392963.614318707","4334.18013856813","87.5612009237875"
"33070","2020",8,8,0,100,0,"283318.75","2898.875","99.75"
"33071","2020",9,9,0,100,0,"150311.111111111","1457.11111111111","105.111111111111"
"33072","2020",1,1,0,100,0,270000,2727,99
"33073","2020",10,9,1,90,10,119550,1296,"91.7"
"33074","2020",1,1,0,100,0,40000,667,60
"33075","2020",322,126,196,"39.1304347826087","60.8695652173913","289488.133540373","3609.82608695652","80.0776397515528"
"33076","2020",9,9,0,100,0,"160483.333333333","1859.88888888889","87.3333333333333"
"33077","2020",30,29,1,"96.6666666666667","3.33333333333333","308547.733333333","2901.33333333333","114.5"
"33078","2020",3,3,0,100,0,"140333.333333333",1209,113
"33079","2020",1,1,0,100,0,230500,2022,114
"33080","2020",83,52,31,"62.6506024096386","37.3493975903614","269484.903614458","3202.93975903614","84.710843373494"
"33081","2020",38,30,8,"78.9473684210526","21.0526315789474","151720.131578947","1918.10526315789","83.5"
"33082","2020",15,15,0,100,0,220420,"2076.93333333333",109
"33083","2020",8,8,0,100,0,296203,"2980.125","99.625"
"33084","2020",27,20,7,"74.0740740740741","25.9259259259259","250086.481481481","2705.74074074074","92.1851851851852"
"33085","2020",35,32,3,"91.4285714285714","8.57142857142857","374539.657142857","3040.31428571429","127.4"
"33086","2020",3,3,0,100,0,83000,1265,"66.6666666666667"
"33087","2020",4,4,0,100,0,109000,"1271.25","91.75"
"33088","2020",8,8,0,100,0,133025,"1367.25","99.875"
"33089","2020",7,7,0,100,0,143200,"1113.28571428571","128.285714285714"
"33090","2020",47,39,8,"82.9787234042553","17.0212765957447","323179.510638298","3516.36170212766","94.6382978723404"
"33093","2020",7,7,0,100,0,"208885.714285714",2044,97
"33094","2020",3,3,0,100,0,65308,755,96
"33095","2020",17,15,2,"88.2352941176471","11.7647058823529","144733.529411765","1945.11764705882","95.5294117647059"
"33096","2020",78,50,28,"64.1025641025641","35.8974358974359","232941.153846154","3219.57692307692","83.8589743589744"
"33097","2020",100,62,38,62,38,"209085.28","3314.76","68.41"
"33098","2020",2,2,0,100,0,147500,"2091.5",66
"33099","2020",31,30,1,"96.7741935483871","3.2258064516129","393625.967741935","3500.09677419355","116.258064516129"
"33100","2020",16,16,0,100,0,"147552.8125","1414.3125","106.875"
"33101","2020",11,10,1,"90.9090909090909","9.09090909090909","143717.272727273",1620,"91.1818181818182"
"33102","2020",4,4,0,100,0,185500,"2327.25","88.25"
"33103","2020",1,1,0,100,0,100000,1111,90
"33104","2020",93,70,23,"75.2688172043011","24.7311827956989","222745.47311828","2779.63440860215","84.9569892473118"
"33105","2020",2,2,0,100,0,195975,1530,"129.5"
"33106","2020",15,15,0,100,0,"176413.2","1823.13333333333","101.2"
"33108","2020",59,55,4,"93.2203389830508","6.77966101694915","106622.101694915","1205.49152542373","97.5423728813559"
"33109","2020",33,33,0,100,0,"243821.363636364","2389.57575757576",104
"33111","2020",15,15,0,100,0,"225456.666666667","1612.53333333333","137.533333333333"
"33112","2020",2,2,0,100,0,180000,"1641.5","108.5"
"33113","2020",3,3,0,100,0,"207133.333333333","1451.33333333333","143.666666666667"
"33114","2020",32,19,13,"59.375","40.625","154237.9375","1866.8125","92.125"
"33115","2020",8,8,0,100,0,169500,"1701.125","115.75"
"33116","2020",7,7,0,100,0,"185868.857142857","1751.85714285714","126.142857142857"
"33117","2020",3,3,0,100,0,125000,"2033.33333333333","75.6666666666667"
"33118","2020",14,14,0,100,0,"405994.285714286","3010.57142857143","132.214285714286"
"33119","2020",317,127,190,"40.0630914826498","59.9369085173502","206856.451104101","3269.33123028391","65.8958990536278"
"33120","2020",17,17,0,100,0,"158934.705882353","2103.94117647059","85.3529411764706"
"33121","2020",1,1,0,100,0,270436,1486,182
"33122","2020",174,164,10,"94.2528735632184","5.74712643678161","391734.752873563","3649.85057471264","112.465517241379"
"33123","2020",41,41,0,100,0,"209364.609756098",1931,"114.390243902439"
"33124","2020",7,7,0,100,0,"144571.428571429","1608.14285714286","92.1428571428571"
"33125","2020",26,26,0,100,0,"177968.769230769","1782.96153846154","97.8461538461538"
"33126","2020",7,7,0,100,0,"195782.714285714","1591.71428571429","120.285714285714"
"33128","2020",7,7,0,100,0,"201442.857142857","1411.14285714286","148.857142857143"
"33129","2020",1,1,0,100,0,164000,1726,95
"33130","2020",11,11,0,100,0,232350,"2148.09090909091",108
"33131","2020",4,4,0,100,0,145000,"1458.25","98.5"
"33132","2020",7,7,0,100,0,"201492.857142857","1533.57142857143","124.142857142857"
"33133","2020",1,1,0,100,0,237000,1959,121
"33134","2020",4,4,0,100,0,168145,"1389.5","122.75"
"33135","2020",4,4,0,100,0,235720,"1750.5","138.75"
"33136","2020",8,8,0,100,0,158609,"1273.75","127.375"
"33137","2020",3,3,0,100,0,"221333.333333333","1272.33333333333",173
"33138","2020",120,88,32,"73.3333333333333","26.6666666666667","137528.041666667","1652.95","84.7583333333333"
"33139","2020",1,1,0,100,0,164000,2103,78
"33140","2020",77,57,20,"74.025974025974","25.974025974026","214528.857142857","2627.92207792208","80.5584415584416"
"33141","2020",9,9,0,100,0,246050,"2528.33333333333","100.111111111111"
"33142","2020",23,22,1,"95.6521739130435","4.34782608695652",190861,"1810.78260869565","109.782608695652"
"33143","2020",25,24,1,96,4,"228901.36",2384,102
"33144","2020",9,9,0,100,0,"176863.888888889","1636.22222222222","111.333333333333"
"33145","2020",4,4,0,100,0,314500,"2626.25","115.75"
"33146","2020",27,26,1,"96.2962962962963","3.7037037037037","193217.037037037","2209.7037037037","96.1851851851852"
"33147","2020",7,7,0,100,0,"194849.857142857","1592.57142857143","125.285714285714"
"33149","2020",2,2,0,100,0,172500,"1317.5",133
"33150","2020",9,9,0,100,0,"255909.444444444","2031.22222222222",119
"33151","2020",3,3,0,100,0,"154833.333333333","1782.66666666667","102.333333333333"
"33152","2020",3,3,0,100,0,"135366.666666667","1437.66666666667","101.666666666667"
"33153","2020",3,3,0,100,0,"154033.333333333",1613,"97.6666666666667"
"33154","2020",30,30,0,100,0,114591,"1116.76666666667","110.566666666667"
"33155","2020",3,3,0,100,0,"104673.333333333","1428.33333333333","72.6666666666667"
"33156","2020",7,7,0,100,0,"167993.857142857",1050,"164.428571428571"
"33157","2020",8,7,1,"87.5","12.5","337938.875","2135.5","151.875"
"33158","2020",5,5,0,100,0,194180,"1540.6","128.6"
"33159","2020",33,31,2,"93.9393939393939","6.06060606060606","112250.878787879","1203.12121212121","96.8181818181818"
"33160","2020",10,10,0,100,0,"179744.4","1409.4",125
"33161","2020",9,9,0,100,0,"130293.333333333","1381.33333333333","99.6666666666667"
"33162","2020",309,172,137,"55.663430420712","44.336569579288","274210.291262136","3515.85113268608","79.7443365695793"
"33163","2020",2,2,0,100,0,179500,1791,"101.5"
"33164","2020",9,9,0,100,0,"221316.666666667",2056,"109.777777777778"
"33165","2020",51,42,9,"82.3529411764706","17.6470588235294","296818.509803922","3028.25490196078","96.0980392156863"
"33166","2020",2,2,0,100,0,91750,954,"91.5"
"33167","2020",203,115,88,"56.6502463054187","43.3497536945813","248680.798029557","3158.64039408867","79.9901477832512"
"33168","2020",10,10,0,100,0,148713,"1716.1","84.8"
"33169","2020",1,1,0,100,0,129000,1290,100
"33170","2020",13,13,0,100,0,"142652.538461538","1316.23076923077","114.307692307692"
"33171","2020",1,1,0,100,0,260000,1688,154
"33172","2020",5,5,0,100,0,"153095.8","1433.2","100.8"
"33173","2020",4,4,0,100,0,133750,"1856.5","76.5"
"33174","2020",15,15,0,100,0,"303946.666666667","2206.93333333333","137.933333333333"
"33175","2020",11,11,0,100,0,"236454.545454545",1855,"125.545454545455"
"33176","2020",2,2,0,100,0,161205,"1987.5","80.5"
"33177","2020",44,42,2,"95.4545454545455","4.54545454545455","233624.113636364","2514.34090909091","115.681818181818"
"33178","2020",9,9,0,100,0,"144977.777777778","1483.11111111111",101
"33179","2020",40,35,5,"87.5","12.5","165846.25","1864.35","91.3"
"33180","2020",2,2,0,100,0,705000,2889,"233.5"
"33181","2020",1,1,0,100,0,148000,1510,98
"33182","2020",14,14,0,100,0,"255400.714285714","1698.64285714286","134.571428571429"
"33183","2020",13,12,1,"92.3076923076923","7.69230769230769","194082.230769231","2143.23076923077","92.0769230769231"
"33184","2020",4,4,0,100,0,161375,"1243.5","128.25"
"33185","2020",35,25,10,"71.4285714285714","28.5714285714286","163419.714285714","2073.4","88.5428571428571"
"33186","2020",15,15,0,100,0,"165660.133333333","1458.93333333333","110.333333333333"
"33187","2020",17,14,3,"82.3529411764706","17.6470588235294","135755.882352941","1427.94117647059","101.294117647059"
"33188","2020",5,5,0,100,0,200180,"1670.8","120.4"
"33189","2020",11,11,0,100,0,"173991.454545455","1531.90909090909","115.636363636364"
"33190","2020",1,1,0,100,0,186100,1379,135
"33191","2020",11,11,0,100,0,"106282.181818182","1349.36363636364","83.6363636363636"
"33192","2020",283,128,155,"45.2296819787986","54.7703180212014","275362.360424028","3503.50530035336","78.5618374558304"
"33193","2020",24,24,0,100,0,"189268.125","2156.125","93.25"
"33194","2020",8,8,0,100,0,"214317.5","1822.875","116.375"
"33195","2020",21,19,2,"90.4761904761905","9.52380952380952",143600,1314,"125.571428571429"
"33196","2020",5,5,0,100,0,164772,"1926.6","114.8"
"33197","2020",5,5,0,100,0,219280,1883,119
"33198","2020",28,27,1,"96.4285714285714","3.57142857142857",147025,1288,"114.714285714286"
"33199","2020",416,313,103,"75.2403846153846","24.7596153846154","348580.528846154","4132.125","84.6778846153846"
"33200","2020",151,95,56,"62.9139072847682","37.0860927152318","304238.317880795","3607.26490066225","86.4966887417219"
"33201","2020",12,9,3,75,25,"290892.916666667","2880.66666666667","119.583333333333"
"33202","2020",32,31,1,"96.875","3.125","220692.03125","2277.59375","104.4375"
"33203","2020",144,99,45,"68.75","31.25","201489.673611111","2781.55555555556","73.2083333333333"
"33204","2020",10,10,0,100,0,201250,"1804.8","102.6"
"33205","2020",8,8,0,100,0,229750,"2244.25","110.875"
"33206","2020",7,6,1,"85.7142857142857","14.2857142857143",191800,"2974.57142857143","71.4285714285714"
"33207","2020",68,68,0,100,0,"258195.529411765","2549.48529411765","108.264705882353"
"33208","2020",20,20,0,100,0,"136266.95","1455.6","92.5"
"33209","2020",2,2,0,100,0,330000,2325,150
"33210","2020",2,2,0,100,0,"162249.5","1832.5","88.5"
"33211","2020",10,10,0,100,0,191003,"1907.6","109.4"
"33212","2020",5,5,0,100,0,160600,"1736.2",96
"33213","2020",38,32,6,"84.2105263157895","15.7894736842105","327086.315789474","3452.21052631579","99.6315789473684"
"33214","2020",295,191,104,"64.7457627118644","35.2542372881356","252603.403389831","4052.39322033898","63.7898305084746"
"33215","2020",1,1,0,100,0,165000,2012,82
"33216","2020",3,3,0,100,0,"363333.333333333",1814,"184.333333333333"
"33218","2020",24,24,0,100,0,"171972.916666667","1646.33333333333","108.5"
"33219","2020",32,29,3,"90.625","9.375","240853.03125","2130.9375","113.625"
"33220","2020",21,21,0,100,0,"183977.428571429","1957.71428571429","96.1428571428571"
"33221","2020",14,14,0,100,0,"162743.214285714",1239,"121.571428571429"
"33222","2020",8,8,0,100,0,"226193.75","1808.25","117.875"
"33223","2020",4,4,0,100,0,117600,"808.5",155
"33225","2020",39,39,0,100,0,"204730.923076923","2017.76923076923","106.641025641026"
"33226","2020",40,37,3,"92.5","7.5","208936.625","2318.725","93.725"
"33227","2020",134,81,53,"60.4477611940298","39.5522388059701","132927.679104478","1804.61940298507","75.3358208955224"
"33228","2020",8,8,0,100,0,"141893.75","941.375","147.125"
"33229","2020",134,112,22,"83.5820895522388","16.4179104477612","341925.671641791","4068.9776119403","86.8582089552239"
"33230","2020",5,4,1,80,20,158354,"1563.8","99.4"
"33231","2020",5,5,0,100,0,"260094.6","2008.4","127.2"
"33232","2020",1,1,0,100,0,268760,2688,100
"33233","2020",27,27,0,100,0,"197679.814814815","1779.37037037037","120.962962962963"
"33234","2020",46,41,5,"89.1304347826087","10.8695652173913","429242.826086957","3607.89130434783","123.369565217391"
"33235","2020",4,4,0,100,0,"197312.5",1565,"149.5"
"33236","2020",215,173,42,"80.4651162790698","19.5348837209302","822779.320930233","8193.10697674419","102.827906976744"
"33237","2020",13,13,0,100,0,"211169.230769231",1875,"114.692307692308"
"33238","2020",97,94,3,"96.9072164948454","3.09278350515464","356161.958762887",3477,"105.628865979381"
"33239","2020",7,7,0,100,0,"205642.857142857","1686.57142857143",130
"33240","2020",104,81,23,"77.8846153846154","22.1153846153846","149632.336538462","1587.03846153846","95.0961538461538"
"33241","2020",11,9,2,"81.8181818181818","18.1818181818182","149036.363636364","1990.54545454545","80.5454545454545"
"33242","2020",5,5,0,100,0,208600,"1430.4","142.2"
"33243","2020",403,226,177,"56.0794044665012","43.9205955334988","173285.836228288","2269.29280397022","77.4838709677419"
"33244","2020",3,3,0,100,0,"170666.666666667","1396.33333333333","150.666666666667"
"33245","2020",13,13,0,100,0,"325651.538461538","2629.69230769231","124.692307692308"
"33246","2020",1,1,0,100,0,85000,773,110
"33247","2020",2,2,0,100,0,100000,839,120
"33248","2020",43,43,0,100,0,"218945.581395349","2232.37209302326","100.511627906977"
"33249","2020",232,88,144,"37.9310344827586","62.0689655172414","189798.672413793","2644.63793103448","73.3060344827586"
"33250","2020",3,3,0,100,0,"226606.666666667","1618.33333333333",137
"33251","2020",8,8,0,100,0,244000,"1838.625","142.25"
"33252","2020",8,8,0,100,0,"420846.25","3130.125","133.375"
"33253","2020",7,7,0,100,0,"165357.142857143","1762.42857142857",94
"33254","2020",5,5,0,100,0,"231676.4","1298.4",182
"33255","2020",6,6,0,100,0,"140833.333333333",1242,"111.5"
"33256","2020",71,63,8,"88.7323943661972","11.2676056338028","272735.309859155","2870.94366197183","97.4647887323944"
"33257","2020",3,3,0,100,0,"252616.666666667",1509,169
"33258","2020",3,3,0,100,0,"210083.333333333","1216.33333333333","165.666666666667"
"33259","2020",7,7,0,100,0,"278857.142857143","2457.71428571429","121.428571428571"
"33260","2020",18,18,0,100,0,"291509.222222222","2194.66666666667",139
"33261","2020",10,10,0,100,0,"186223.8","1827.8","108.7"
"33262","2020",51,47,4,"92.156862745098","7.84313725490196","239452.019607843","2774.72549019608","92.843137254902"
"33263","2020",3,3,0,100,0,"223116.666666667","2584.66666666667","91.3333333333333"
"33264","2020",8,8,0,100,0,172375,1744,"115.375"
"33266","2020",10,10,0,100,0,"184458.7","1576.4","125.6"
"33268","2020",38,35,3,"92.1052631578947","7.89473684210526","228121.921052632","2295.5","103.578947368421"
"33269","2020",4,4,0,100,0,"106551.25","1038.25","104.5"
"33270","2020",4,4,0,100,0,"226337.5","2030.5","110.75"
"33272","2020",10,10,0,100,0,"185146.9",1932,"92.3"
"33273","2020",108,73,35,"67.5925925925926","32.4074074074074","313383.083333333","3401.30555555556","94.1481481481482"
"33274","2020",41,36,5,"87.8048780487805","12.1951219512195","306468.87804878","3181.80487804878","98.9512195121951"
"33275","2020",3,3,0,100,0,160000,"2073.33333333333",81
"33277","2020",2,2,0,100,0,173000,"1462.5",117
"33279","2020",3,3,0,100,0,"246766.666666667","1932.33333333333",137
"33280","2020",4,4,0,100,0,181250,1750,"105.75"
"33281","2020",1049,399,650,"38.0362249761678","61.9637750238322","278739.235462345","3678.35462345091","76.2125834127741"
"33282","2020",3,3,0,100,0,"198666.666666667","1740.33333333333","102.666666666667"
"33283","2020",5,5,0,100,0,140100,"1233.6","126.8"
"33284","2020",147,138,9,"93.8775510204082","6.12244897959184","323255.761904762","3276.74829931973","103.047619047619"
"33285","2020",9,9,0,100,0,150950,"1721.44444444444","88.4444444444444"
"33287","2020",13,13,0,100,0,"163413.076923077","1432.53846153846","123.384615384615"
"33288","2020",2,2,0,100,0,222500,2090,111
"33289","2020",24,24,0,100,0,"161995.75","1208.83333333333","128.916666666667"
"33290","2020",20,20,0,100,0,"185458.5","1684.3","118.85"
"33291","2020",2,2,0,100,0,149750,"1816.5","82.5"
"33293","2020",38,30,8,"78.9473684210526","21.0526315789474","277792.263157895","2726.05263157895","103.473684210526"
"33294","2020",11,11,0,100,0,"171127.272727273","1532.27272727273",113
"33295","2020",1,1,0,100,0,140000,1474,95
"33296","2020",14,14,0,100,0,"174216.071428571","1604.35714285714","103.357142857143"
"33297","2020",32,32,0,100,0,"222991.875",2088,"107.84375"
"33298","2020",9,9,0,100,0,"329550.555555556","2466.33333333333","139.111111111111"
"33299","2020",7,7,0,100,0,"185957.142857143",1672,"112.571428571429"
"33300","2020",17,17,0,100,0,"213692.941176471","2131.11764705882","105.294117647059"
"33301","2020",3,3,0,100,0,"253866.666666667",1742,"177.333333333333"
"33302","2020",3,3,0,100,0,"179093.333333333","1709.66666666667","101.666666666667"
"33303","2020",15,15,0,100,0,"247566.8","2341.2","99.6666666666667"
"33304","2020",2,2,0,100,0,130250,"2085.5","80.5"
"33305","2020",12,12,0,100,0,"187563.583333333","2013.75","94.9166666666667"
"33306","2020",6,6,0,100,0,"223881.666666667",1771,"134.166666666667"
"33307","2020",23,23,0,100,0,"199186.956521739","1861.78260869565","108.217391304348"
"33308","2020",3,3,0,100,0,"200666.666666667","1787.66666666667",115
"33309","2020",9,9,0,100,0,"164322.222222222","1450.33333333333","117.222222222222"
"33310","2020",3,3,0,100,0,"206333.333333333","1639.66666666667",135
"33311","2020",31,22,9,"70.9677419354839","29.0322580645161","158048.387096774","1877.48387096774",89
"33312","2020",134,89,45,"66.4179104477612","33.5820895522388","265057.902985075","3186.82089552239","82.4701492537313"
"33314","2020",50,50,0,100,0,"157068.4","1737.52","94.14"
"33315","2020",24,24,0,100,0,"151354.583333333","1508.5","105.166666666667"
"33316","2020",17,17,0,100,0,"151641.764705882","1207.52941176471","125.588235294118"
"33317","2020",10,10,0,100,0,"232716.1","2205.2","106.4"
"33318","2020",725,428,297,"59.0344827586207","40.9655172413793","304179.011034483","3721.59586206897","83.0372413793103"
"33320","2020",7,7,0,100,0,"179285.714285714","1729.57142857143","106.428571428571"
"33321","2020",17,17,0,100,0,"227222.470588235","2185.76470588235","101.529411764706"
"33322","2020",86,81,5,"94.1860465116279","5.81395348837209","325034.069767442","3209.63953488372","103.732558139535"
"33323","2020",15,15,0,100,0,"210474.133333333","1969.53333333333",106
"33324","2020",83,58,25,"69.8795180722892","30.1204819277108","108802.65060241","1262.40963855422","87.3614457831325"
"33325","2020",17,17,0,100,0,"188847.941176471","1535.17647058824","125.705882352941"
"33326","2020",1,1,0,100,0,60000,1000,60
"33327","2020",32,30,2,"93.75","6.25","191937.46875","2045.125","99.125"
"33328","2020",6,6,0,100,0,"144333.333333333",1467,"106.166666666667"
"33329","2020",3,3,0,100,0,269800,"2347.66666666667","111.333333333333"
"33330","2020",48,45,3,"93.75","6.25","354294.333333333","3096.58333333333","119.5625"
"33331","2020",5,5,0,100,0,311826,"1915.6","163.2"
"33332","2020",15,15,0,100,0,"151855.4","1471.6","106.266666666667"
"33333","2020",39,39,0,100,0,"299740.512820513","3098.66666666667","100.641025641026"
"33334","2020",24,21,3,"87.5","12.5","207236.833333333","2461.54166666667","86.4166666666667"
"33335","2020",3,3,0,100,0,"210907.333333333",2898,"73.3333333333333"
"33336","2020",17,17,0,100,0,"106382.352941176",1052,"103.705882352941"
"33337","2020",29,28,1,"96.551724137931","3.44827586206897","179431.793103448","1743.96551724138","107.413793103448"
"33339","2020",17,17,0,100,0,"268544.705882353","1928.94117647059","144.294117647059"
"33341","2020",21,20,1,"95.2380952380952","4.76190476190476","256412.238095238","2352.09523809524","115.666666666667"
"33342","2020",7,7,0,100,0,"199464.285714286","2493.57142857143","83.1428571428571"
"33343","2020",12,12,0,100,0,"169942.5","1950.33333333333","90.75"
"33344","2020",5,5,0,100,0,145694,"1371.8","131.6"
"33345","2020",6,6,0,100,0,"150134.666666667","1324.66666666667","115.833333333333"
"33346","2020",6,6,0,100,0,"175633.333333333","1605.66666666667",125
"33347","2020",5,5,0,100,0,205300,"1428.6",140
"33348","2020",19,19,0,100,0,"164627.315789474","1700.94736842105","102.526315789474"
"33349","2020",18,18,0,100,0,"466147.222222222","3207.72222222222","151.111111111111"
"33350","2020",28,28,0,100,0,"170551.571428571","1631.67857142857","102.857142857143"
"33351","2020",13,13,0,100,0,"119126.538461538","1101.38461538462","113.307692307692"
"33352","2020",59,56,3,"94.9152542372881","5.08474576271187","122412.016949153","1258.61016949153","99.2881355932203"
"33353","2020",1,1,0,100,0,148200,1059,140
"33354","2020",2,2,0,100,0,292628,1180,241
"33355","2020",19,19,0,100,0,"198551.947368421","1992.94736842105","98.6315789473684"
"33356","2020",7,7,0,100,0,"258971.428571429","2223.57142857143","111.285714285714"
"33357","2020",25,25,0,100,0,"219876.4","2120.16","104.32"
"33358","2020",8,8,0,100,0,"165787.5","1566.625","107.25"
"33359","2020",5,5,0,100,0,164875,"1290.6","130.4"
"33360","2020",2,2,0,100,0,73175,859,98
"33361","2020",7,7,0,100,0,"115428.571428571",1291,"91.2857142857143"
"33362","2020",13,13,0,100,0,"178022.384615385","1899.38461538462","100.846153846154"
"33363","2020",48,47,1,"97.9166666666667","2.08333333333333","309497.583333333","2860.5625","110.3125"
"33364","2020",3,3,0,100,0,"161333.333333333","1852.33333333333",84
"33365","2020",1,1,0,100,0,173350,2709,64
"33366","2020",182,128,54,"70.3296703296703","29.6703296703297","203222.901098901","2347.92857142857","88.0824175824176"
"33367","2020",5,5,0,100,0,194600,"1324.4","146.6"
"33369","2020",2,2,0,100,0,147775,"1731.5","85.5"
"33370","2020",4,4,0,100,0,"172022.5",1521,"122.75"
"33373","2020",8,8,0,100,0,"140071.75",1449,"100.375"
"33374","2020",10,10,0,100,0,110900,"1264.9","96.6"
"33375","2020",5,5,0,100,0,240669,1743,144
"33376","2020",85,73,12,"85.8823529411765","14.1176470588235","419441.329411765","3559.36470588235","118.094117647059"
"33377","2020",2,2,0,100,0,"266082.5",2170,"119.5"
"33378","2020",15,15,0,100,0,122460,"1164.86666666667","105.4"
"33379","2020",4,4,0,100,0,142611,"1683.25",86
"33380","2020",13,13,0,100,0,"111202.846153846","923.923076923077",122
"33381","2020",50,36,14,72,28,"247245.2","2600.24","95.68"
"33382","2020",24,24,0,100,0,"167726.666666667","1572.41666666667","112.5"
"33383","2020",9,9,0,100,0,"126518.333333333","1226.55555555556","109.888888888889"
"33384","2020",3,3,0,100,0,188900,"2526.33333333333",75
"33385","2020",9,9,0,100,0,"138866.666666667","1126.77777777778",137
"33387","2020",21,21,0,100,0,"187393.80952381","1763.19047619048","107.142857142857"
"33388","2020",9,9,0,100,0,"173954.666666667","2115.66666666667","93.1111111111111"
"33389","2020",45,45,0,100,0,"121330.444444444","1261.35555555556","100.844444444444"
"33390","2020",5,5,0,100,0,232200,"1509.2","137.4"
"33391","2020",7,7,0,100,0,"193535.714285714",1784,"118.571428571429"
"33392","2020",8,8,0,100,0,133875,"1175.5","117.875"
"33393","2020",56,53,3,"94.6428571428571","5.35714285714286","173033.321428571","1715.58928571429","108.125"
"33394","2020",15,15,0,100,0,"271152.8","3377.4","97.8666666666667"
"33395","2020",32,31,1,"96.875","3.125","98132.8125","1212.5","84.125"
"33397","2020",41,37,4,"90.2439024390244","9.75609756097561","274617.43902439","2878.78048780488","96.7317073170732"
"33398","2020",2,2,0,100,0,175500,1480,126
"33399","2020",2,2,0,100,0,154000,"1476.5",105
"33400","2020",3,3,0,100,0,"238666.666666667","3297.66666666667","102.333333333333"
"33401","2020",4,4,0,100,0,"656318.75","3158.25","166.25"
"33402","2020",47,34,13,"72.3404255319149","27.6595744680851","79622.7659574468","921.382978723404","91.3404255319149"
"33403","2020",1,1,0,100,0,282000,2136,132
"33404","2020",3,3,0,100,0,208000,2068,"106.333333333333"
"33405","2020",3,3,0,100,0,"188166.666666667","1312.33333333333","147.666666666667"
"33406","2020",6,6,0,100,0,"284766.666666667","3356.5","97.8333333333333"
"33407","2020",11,11,0,100,0,"282748.636363636","2817.90909090909","107.545454545455"
"33408","2020",5,5,0,100,0,296400,"2738.8","112.4"
"33411","2020",3,3,0,100,0,200000,"1799.33333333333","101.666666666667"
"33412","2020",13,13,0,100,0,"141807.692307692","1548.30769230769","92.6923076923077"
"33413","2020",25,24,1,96,4,"270354.28","2441.08","119.08"
"33414","2020",3,3,0,100,0,"323333.333333333","3093.66666666667","114.333333333333"
"33415","2020",34,31,3,"91.1764705882353","8.82352941176471","192930.205882353","2059.76470588235","95.9705882352941"
"33416","2020",18,18,0,100,0,"178470.833333333","1496.38888888889","122.277777777778"
"33417","2020",36,35,1,"97.2222222222222","2.77777777777778","325156.805555556","3124.25","109.555555555556"
"33418","2020",7,7,0,100,0,"168334.285714286","1753.28571428571","99.5714285714286"
"33419","2020",1,1,0,100,0,146300,2709,54
"33420","2020",1,1,0,100,0,310000,2081,149
"33421","2020",6,6,0,100,0,"240033.333333333",1883,121
"33422","2020",100,76,24,76,24,"346768.38","3609.77","98.31"
"33423","2020",5,5,0,100,0,113720,"1092.4","107.4"
"33424","2020",68,50,18,"73.5294117647059","26.4705882352941","169296.352941176","1892.79411764706","90.8823529411765"
"33425","2020",15,15,0,100,0,"200145.466666667","2208.46666666667","97.7333333333333"
"33426","2020",3,3,0,100,0,"218666.666666667","2264.66666666667","96.6666666666667"
"33427","2020",6,6,0,100,0,"184578.333333333","1261.5","139.5"
"33429","2020",6,6,0,100,0,"207521.666666667","1674.16666666667","131.333333333333"
"33431","2020",3,3,0,100,0,199000,"2329.33333333333",85
"33432","2020",1,1,0,100,0,217000,1669,130
"33433","2020",92,83,9,"90.2173913043478","9.78260869565217","301092.673913043","2930.0652173913","99.7065217391304"
"33434","2020",31,24,7,"77.4193548387097","22.5806451612903","177991.451612903","2304.90322580645","78.6774193548387"
"33435","2020",47,27,20,"57.4468085106383","42.5531914893617","151496.170212766","1672.17021276596","91.9574468085106"
"33436","2020",15,14,1,"93.3333333333333","6.66666666666667","249613.066666667","2207.86666666667","115.533333333333"
"33437","2020",33,33,0,100,0,"222995.484848485","1635.93939393939","132.969696969697"
"33438","2020",23,23,0,100,0,"183323.913043478","1863.30434782609","98.9565217391304"
"33439","2020",15,14,1,"93.3333333333333","6.66666666666667",193336,"1805.06666666667","111.8"
"33441","2020",24,17,7,"70.8333333333333","29.1666666666667","126830.166666667","1539.91666666667","80.625"
"33442","2020",9,9,0,100,0,"179211.111111111","1568.55555555556","120.222222222222"
"33443","2020",1,1,0,100,0,149000,1419,105
"33444","2020",5,5,0,100,0,225390,"2272.2","97.8"
"33445","2020",7,7,0,100,0,203380,"1865.42857142857","109.571428571429"
"33446","2020",2,2,0,100,0,232000,"1314.5",176
"33447","2020",51,50,1,"98.0392156862745","1.96078431372549","137898.058823529","1563.98039215686","92.5490196078431"
"33448","2020",34,33,1,"97.0588235294118","2.94117647058824","353296.470588235","3144.26470588235","113.294117647059"
"33449","2020",341,267,74,"78.2991202346041","21.7008797653959","329908.988269795","3466.47214076246","97.2111436950147"
"33450","2020",8,8,0,100,0,141538,"1434.875","99.625"
"33451","2020",3,3,0,100,0,157500,"1171.66666666667",149
"33452","2020",7,7,0,100,0,"194162.857142857","1777.85714285714","108.285714285714"
"33453","2020",4,4,0,100,0,267595,1989,"134.5"
"33454","2020",22,22,0,100,0,"327253.272727273","2873.95454545455","118.863636363636"
"33456","2020",3,3,0,100,0,"178333.333333333","1188.66666666667","150.333333333333"
"33457","2020",9,9,0,100,0,"240435.555555556","2107.44444444444","116.777777777778"
"33458","2020",13,13,0,100,0,"147639.692307692","1431.76923076923","108.846153846154"
"33460","2020",9,9,0,100,0,"172768.333333333","1940.33333333333",86
"33461","2020",4,4,0,100,0,297100,1782,"157.5"
"33462","2020",2,2,0,100,0,92750,"1032.5",92
"33463","2020",21,21,0,100,0,"176941.142857143","1922.09523809524","94.9523809523809"
"33464","2020",6,6,0,100,0,"155633.333333333","2039.16666666667","83.5"
"33465","2020",12,12,0,100,0,"187722.5","1685.83333333333","115.666666666667"
"33466","2020",80,30,50,"37.5","62.5","140542.2375","2026.4125","66.35"
"33467","2020",6,6,0,100,0,"202238.333333333","1640.83333333333","135.666666666667"
"33468","2020",10,10,0,100,0,"194513.6","1870.2","102.2"
"33470","2020",4,4,0,100,0,354125,"3039.75","123.75"
"33471","2020",14,14,0,100,0,"212042.142857143","1780.35714285714","116.357142857143"
"33472","2020",6,6,0,100,0,"210391.666666667","1730.33333333333","121.666666666667"
"33473","2020",31,29,2,"93.5483870967742","6.45161290322581","157293.677419355","1469.03225806452","116.935483870968"
"33474","2020",41,41,0,100,0,"336525.780487805","2727.48780487805","127.90243902439"
"33475","2020",6,6,0,100,0,"133916.666666667","1536.83333333333","84.6666666666667"
"33476","2020",7,7,0,100,0,171720,"1211.28571428571","117.714285714286"
"33477","2020",16,16,0,100,0,"118918.75","1318.9375","89.0625"
"33478","2020",55,46,9,"83.6363636363636","16.3636363636364","111728.090909091","1510.36363636364","74.4"
"33479","2020",2,2,0,100,0,172875,1765,97
"33480","2020",10,10,0,100,0,166700,"1798.1","95.8"
"33481","2020",1,1,0,100,0,115000,1045,110
"33482","2020",6,6,0,100,0,"263516.666666667","1593.33333333333","157.666666666667"
"33483","2020",65,58,7,"89.2307692307692","10.7692307692308","348395.923076923","2825.41538461538","121.107692307692"
"33484","2020",25,21,4,84,16,159410,"1681.48","100.28"
"33485","2020",27,26,1,"96.2962962962963","3.7037037037037","183664.814814815",1840,"103.407407407407"
"33486","2020",5,5,0,100,0,207446,"1955.2","107.4"
"33487","2020",9,9,0,100,0,"273550.333333333","2363.22222222222","111.555555555556"
"33488","2020",5,5,0,100,0,265128,"2046.4","128.2"
"33489","2020",6,6,0,100,0,220550,"1604.16666666667",145
"33490","2020",45,40,5,"88.8888888888889","11.1111111111111","144973.333333333","1719.88888888889","87.7333333333333"
"33491","2020",7,7,0,100,0,206240,1958,"120.571428571429"
"33492","2020",34,25,9,"73.5294117647059","26.4705882352941","145388.382352941","1730.58823529412","81.7352941176471"
"33493","2020",9,9,0,100,0,"158638.888888889","1429.22222222222","132.111111111111"
"33494","2020",13,13,0,100,0,"384121.538461538","3388.23076923077","113.615384615385"
"33496","2020",28,28,0,100,0,"301818.107142857","2847.14285714286","111.035714285714"
"33498","2020",95,86,9,"90.5263157894737","9.47368421052632","265856.010526316","2732.21052631579","100.084210526316"
"33499","2020",6,6,0,100,0,"142367.5","1287.83333333333","111.666666666667"
"33500","2020",5,5,0,100,0,162680,"1732.6","108.6"
"33501","2020",33,32,1,"96.969696969697","3.03030303030303","322714.424242424","2984.75757575758","109.848484848485"
"33502","2020",9,9,0,100,0,"168213.888888889","1830.66666666667","99.3333333333333"
"33503","2020",5,5,0,100,0,326120,"2595.4","126.2"
"33504","2020",8,8,0,100,0,"235032.875","2234.125","112.75"
"33505","2020",17,17,0,100,0,212540,"2062.35294117647","106.941176470588"
"33506","2020",27,22,5,"81.4814814814815","18.5185185185185",158042,"1566.51851851852","101.444444444444"
"33507","2020",4,4,0,100,0,225375,"1446.75","164.75"
"33508","2020",7,7,0,100,0,"194235.714285714","1673.57142857143","120.285714285714"
"33509","2020",5,5,0,100,0,220400,"1889.8",132
"33510","2020",3,3,0,100,0,"177766.666666667","1680.66666666667",102
"33511","2020",5,5,0,100,0,"158655.8","1772.8","91.2"
"33512","2020",5,5,0,100,0,199720,"1653.6","126.4"
"33513","2020",1,1,0,100,0,258000,1665,155
"33514","2020",169,109,60,"64.4970414201183","35.5029585798817","184294.514792899","2931.31360946746","66.3136094674556"
"33515","2020",3,3,0,100,0,"166166.666666667",1579,107
"33516","2020",3,3,0,100,0,"186266.666666667","1734.66666666667","105.666666666667"
"33517","2020",28,28,0,100,0,"243349.392857143","2370.67857142857","99.75"
"33518","2020",14,14,0,100,0,"220413.428571429","2277.28571428571","98.5"
"33519","2020",114,101,13,"88.5964912280702","11.4035087719298","345818.070175439","3659.55263157895","98.0964912280702"
"33520","2020",4,4,0,100,0,"208512.75",1350,"151.5"
"33521","2020",10,10,0,100,0,198791,2176,"92.1"
"33522","2020",670,251,419,"37.4626865671642","62.5373134328358","263157.32238806","4184.77014925373","64.9850746268657"
"33523","2020",20,19,1,95,5,210502,"2019.3","106.85"
"33525","2020",11,10,1,"90.9090909090909","9.09090909090909","165040.909090909","1921.54545454545","87.7272727272727"
"33526","2020",1,1,0,100,0,345000,2464,140
"33527","2020",116,88,28,"75.8620689655172","24.1379310344828","312703.413793103","3476.08620689655","91.1034482758621"
"33528","2020",4,4,0,100,0,347625,"2560.75","135.5"
"33529","2020",491,394,97,"80.2443991853361","19.7556008146639","513462.631364562","5097.32382892057","96.3747454175153"
"33530","2020",14,14,0,100,0,"204002.714285714","1795.57142857143","113.5"
"33531","2020",3,3,0,100,0,149000,"1390.66666666667","108.333333333333"
"33533","2020",27,24,3,"88.8888888888889","11.1111111111111","180730.111111111","2035.59259259259","92.6666666666667"
"33534","2020",10,7,3,70,30,"230739.1","2678.3","90.7"
"33535","2020",44,38,6,"86.3636363636364","13.6363636363636","335125.227272727","3302.65909090909","102.295454545455"
"33536","2020",8,8,0,100,0,"427812.5","3435.125","129.125"
"33537","2020",6,6,0,100,0,"195116.666666667","1821.5","121.166666666667"
"33538","2020",12,12,0,100,0,"107458.333333333","1254.91666666667","84.4166666666667"
"33539","2020",58,53,5,"91.3793103448276","8.62068965517241","265017.24137931","2257.44827586207","121.086206896552"
"33540","2020",75,73,2,"97.3333333333333","2.66666666666667","208368.04","2700.93333333333","82.0133333333333"
"33541","2020",25,25,0,100,0,"201023.08","2106.08","96.64"
"33542","2020",9,9,0,100,0,"226432.777777778","2335.66666666667","97.4444444444444"
"33543","2020",12,12,0,100,0,"214424.583333333","1817.16666666667","118.416666666667"
"33544","2020",70,33,37,"47.1428571428571","52.8571428571429","131041.028571429","2089.71428571429","62.2714285714286"
"33545","2020",16,15,1,"93.75","6.25","146308.6875","1379.5625","115.4375"
"33546","2020",4,4,0,100,0,"194613.5","1889.5","109.25"
"33547","2020",15,15,0,100,0,"185444.066666667","1513.86666666667","126.866666666667"
"33548","2020",17,17,0,100,0,"198544.352941176","1841.17647058824","111.470588235294"
"33549","2020",3,3,0,100,0,207000,2318,"102.333333333333"
"33550","2020",433,295,138,"68.1293302540416","31.8706697459584","287365.983833718","3596.61662817552","80.4849884526559"
"33551","2020",4,4,0,100,0,176150,"1627.5","106.25"
"33552","2020",10,10,0,100,0,206730,1964,"106.8"
"33553","2020",10,9,1,90,10,"206766.5","2419.8","84.7"
"33554","2020",28,28,0,100,0,334022,"3027.67857142857","116.571428571429"
"33555","2020",72,61,11,"84.7222222222222","15.2777777777778","294892.013888889","3214.44444444444","92.8611111111111"
"33001","2021",27,26,1,"96.2962962962963","3.7037037037037","166670.407407407","1769.55555555556","99.037037037037"
"33002","2021",11,11,0,100,0,"222432.181818182","2011.18181818182","121.727272727273"
"33003","2021",207,178,29,"85.9903381642512","14.0096618357488","264710.961352657","2939.55072463768","91.6859903381642"
"33004","2021",37,33,4,"89.1891891891892","10.8108108108108","199464.216216216","2360.43243243243","88.4864864864865"
"33005","2021",297,229,68,"77.1043771043771","22.8956228956229","448904.373737374","5402.45117845118","87.3299663299663"
"33006","2021",10,10,0,100,0,"122077.2","1163.4","100.7"
"33007","2021",14,14,0,100,0,"314521.428571429","2907.92857142857","113.214285714286"
"33008","2021",3,3,0,100,0,196000,"2082.33333333333","96.6666666666667"
"33009","2021",597,153,444,"25.6281407035176","74.3718592964824","487733.102177554","7471.01507537688","65.2345058626466"
"33010","2021",8,8,0,100,0,"290343.75","2244.5","128.875"
"33011","2021",213,167,46,"78.4037558685446","21.5962441314554","368835.868544601","4649.13615023474","81.6431924882629"
"33012","2021",51,50,1,"98.0392156862745","1.96078431372549","376649.68627451","3299.94117647059","116.039215686275"
"33013","2021",104,76,28,"73.0769230769231","26.9230769230769","299267.307692308","3473.29807692308","87.5961538461538"
"33014","2021",10,10,0,100,0,167115,"1880.4","96.8"
"33015","2021",30,27,3,90,10,"217603.133333333",2162,"101.933333333333"
"33016","2021",4,4,0,100,0,"253062.5","3169.75","80.75"
"33017","2021",3,3,0,100,0,"300566.666666667","1887.66666666667",159
"33018","2021",49,44,5,"89.7959183673469","10.2040816326531","214336.653061224","2315.75510204082","94.8571428571429"
"33019","2021",176,122,54,"69.3181818181818","30.6818181818182","301285.261363636","3696.98863636364","81.9261363636364"
"33020","2021",2,2,0,100,0,407000,"3156.5","119.5"
"33021","2021",19,19,0,100,0,"205129.736842105","1935.10526315789","110.421052631579"
"33022","2021",47,43,4,"91.4893617021277","8.51063829787234","288886.595744681","2799.53191489362","107.31914893617"
"33023","2021",21,21,0,100,0,"334902.380952381","2943.7619047619","116.095238095238"
"33025","2021",9,9,0,100,0,"214964.444444444","1858.22222222222",123
"33026","2021",2,2,0,100,0,215650,2737,81
"33027","2021",4,4,0,100,0,"189637.5","1785.75","111.25"
"33028","2021",15,15,0,100,0,"268386.8","2422.73333333333","114.2"
"33029","2021",69,61,8,"88.4057971014493","11.5942028985507","324621.739130435","3151.50724637681","105.623188405797"
"33030","2021",43,43,0,100,0,202113,"1962.6976744186","104.674418604651"
"33031","2021",1,1,0,100,0,140000,511,274
"33032","2021",61,37,24,"60.655737704918","39.344262295082","240954.393442623","3115.73770491803","78.9672131147541"
"33033","2021",9,7,2,"77.7777777777778","22.2222222222222","460382.222222222","4437.22222222222","94.2222222222222"
"33034","2021",8,8,0,100,0,160000,"1653.375","96.75"
"33035","2021",9,9,0,100,0,"167039.444444444","1926.77777777778","104.777777777778"
"33036","2021",61,58,3,"95.0819672131148","4.91803278688525","208817.327868852","1852.62295081967","121.688524590164"
"33037","2021",28,27,1,"96.4285714285714","3.57142857142857","311854.571428571","3294.25","97.8214285714286"
"33038","2021",15,15,0,100,0,"171933.333333333","1794.4","99.9333333333333"
"33039","2021",524,300,224,"57.2519083969466","42.7480916030534","314333.625954198","4182.35687022901","75.543893129771"
"33040","2021",16,16,0,100,0,"192393.75","2056.1875","105.3125"
"33042","2021",93,88,5,"94.6236559139785","5.37634408602151","293000.612903226","2958.18279569892","100.537634408602"
"33043","2021",3,3,0,100,0,"131666.666666667","1380.33333333333","91.6666666666667"
"33044","2021",3,3,0,100,0,"408133.333333333",2402,178
"33045","2021",2,2,0,100,0,"48284.5","635.5","66.5"
"33046","2021",23,22,1,"95.6521739130435","4.34782608695652","225972.869565217","1988.78260869565","115.130434782609"
"33047","2021",22,22,0,100,0,"170169.409090909","1612.18181818182","113.5"
"33048","2021",2,2,0,100,0,223750,1874,"111.5"
"33049","2021",38,38,0,100,0,"306227.263157895","2849.44736842105","113.789473684211"
"33050","2021",5,5,0,100,0,187077,"1840.4","112.4"
"33051","2021",198,158,40,"79.7979797979798","20.2020202020202","293545.146464646","3464.41414141414","87.0505050505051"
"33052","2021",23,17,6,"73.9130434782609","26.0869565217391","191110.869565217","2136.52173913043","93.1739130434783"
"33053","2021",3,3,0,100,0,"217666.666666667","1778.33333333333","120.666666666667"
"33054","2021",2,2,0,100,0,155000,"1769.5","87.5"
"33055","2021",6,6,0,100,0,249095,"1866.33333333333","133.666666666667"
"33056","2021",176,105,71,"59.6590909090909","40.3409090909091","293407.431818182","3442.09659090909","88.0113636363636"
"33057","2021",7,7,0,100,0,"134028.571428571","1324.57142857143",100
"33058","2021",132,89,43,"67.4242424242424","32.5757575757576","124259.181818182","1535.95454545455","83.5681818181818"
"33059","2021",4,4,0,100,0,217825,"1721.75","124.5"
"33060","2021",7,7,0,100,0,"230415.857142857","2439.42857142857","107.571428571429"
"33061","2021",14,14,0,100,0,"400738.285714286","3462.78571428571","114.642857142857"
"33062","2021",3,3,0,100,0,302250,"2314.33333333333","126.333333333333"
"33063","2021",5471,1500,3971,"27.4172911716322","72.5827088283678","359325.401389143","4965.28057027966","73.0332663132883"
"33064","2021",1,1,0,100,0,129000,1466,88
"33065","2021",35,34,1,"97.1428571428571","2.85714285714286","566167.171428571","4134.11428571429","138.257142857143"
"33066","2021",2,2,0,100,0,"72283.5","642.5","112.5"
"33067","2021",46,44,2,"95.6521739130435","4.34782608695652","173880.282608696","1831.82608695652","98.8695652173913"
"33068","2021",1,1,0,100,0,100000,1000,100
"33069","2021",554,251,303,"45.3068592057762","54.6931407942238","402764.406137184","4599.13357400722","85.2563176895307"
"33070","2021",15,15,0,100,0,"286417.333333333",2689,"107.866666666667"
"33071","2021",13,13,0,100,0,"267860.769230769","1853.30769230769","155.307692307692"
"33072","2021",2,2,0,100,0,235050,1979,"113.5"
"33073","2021",26,26,0,100,0,"124958.115384615","1287.73076923077","100.115384615385"
"33075","2021",416,150,266,"36.0576923076923","63.9423076923077","295059.932692308","3799.96394230769","76.4495192307692"
"33076","2021",8,8,0,100,0,"252468.75","1799.125","137.875"
"33077","2021",31,31,0,100,0,"331693.387096774","2826.09677419355","119.645161290323"
"33078","2021",10,10,0,100,0,217470,"2011.5","114.6"
"33079","2021",5,5,0,100,0,318288,"2473.4","135.6"
"33080","2021",111,77,34,"69.3693693693694","30.6306306306306","269085.243243243","3435.64864864865","79.7747747747748"
"33081","2021",37,24,13,"64.8648648648649","35.1351351351351","171721.27027027","2181.54054054054","80.3513513513514"
"33082","2021",23,23,0,100,0,"256235.260869565","2559.39130434783","102.260869565217"
"33083","2021",14,14,0,100,0,"348501.714285714","3098.28571428571",115
"33084","2021",29,24,5,"82.7586206896552","17.2413793103448","324794.275862069","3201.51724137931","98.448275862069"
"33085","2021",49,49,0,100,0,"421262.142857143","3567.5306122449","119.163265306122"
"33086","2021",4,4,0,100,0,"405187.5","2973.5","132.25"
"33087","2021",7,7,0,100,0,"201835.714285714","1422.57142857143","145.857142857143"
"33088","2021",3,3,0,100,0,149500,"1839.66666666667","77.3333333333333"
"33089","2021",6,6,0,100,0,"152758.333333333","1353.66666666667","113.666666666667"
"33090","2021",51,49,2,"96.078431372549","3.92156862745098","373878.921568627","3715.45098039216","105.843137254902"
"33093","2021",14,14,0,100,0,"235947.428571429","2584.5","93.2142857142857"
"33094","2021",5,5,0,100,0,174900,"1934.6","94.2"
"33095","2021",20,20,0,100,0,"157696.5","1493.55","103.65"
"33096","2021",127,89,38,"70.0787401574803","29.9212598425197","250167.874015748","3272.81102362205","82.9133858267717"
"33097","2021",98,53,45,"54.0816326530612","45.9183673469388","236106.214285714","3691.16326530612","68.2448979591837"
"33098","2021",10,10,0,100,0,199570,"2043.8","104.1"
"33099","2021",59,58,1,"98.3050847457627","1.69491525423729","408781.779661017","3455.25423728814","122.322033898305"
"33100","2021",13,13,0,100,0,134615,"1284.53846153846","105.076923076923"
"33101","2021",7,7,0,100,0,"161835.714285714","1664.14285714286","99.1428571428571"
"33102","2021",6,6,0,100,0,155550,"990.5","147.5"
"33103","2021",3,3,0,100,0,"136533.333333333","1413.33333333333","96.6666666666667"
"33104","2021",99,75,24,"75.7575757575758","24.2424242424242","223207.474747475","2610.9696969697","88.3838383838384"
"33105","2021",3,3,0,100,0,"225383.333333333",1666,125
"33106","2021",20,19,1,95,5,"214435.7","1659.2",134
"33108","2021",61,53,8,"86.8852459016393","13.1147540983607","132581.803278689","1363.09836065574","102.081967213115"
"33109","2021",35,35,0,100,0,"273808.657142857","2898.88571428571","96.3714285714286"
"33111","2021",17,16,1,"94.1176470588235","5.88235294117647","181555.941176471","1583.52941176471","120.117647058824"
"33112","2021",2,2,0,100,0,"277447.5",1838,142
"33114","2021",58,34,24,"58.6206896551724","41.3793103448276","165842.931034483","1956.43103448276","87.7068965517241"
"33115","2021",4,4,0,100,0,"176537.5",1270,138
"33116","2021",4,4,0,100,0,272252,1982,"135.5"
"33117","2021",2,2,0,100,0,208375,1492,"139.5"
"33118","2021",26,26,0,100,0,"496821.884615385","3875.11538461538","126.692307692308"
"33119","2021",371,157,214,"42.3180592991914","57.6819407008086","227103.409703504","3400.75741239892","67.1698113207547"
"33120","2021",35,35,0,100,0,"266646.542857143","2179.94285714286","125.428571428571"
"33121","2021",1,1,0,100,0,241000,1181,204
"33122","2021",176,169,7,"96.0227272727273","3.97727272727273","421390.346590909","3767.02272727273","116.159090909091"
"33123","2021",31,31,0,100,0,"241124.258064516","1878.03225806452","128.967741935484"
"33124","2021",7,7,0,100,0,"202798.857142857","1518.85714285714","125.285714285714"
"33125","2021",33,33,0,100,0,"239095.484848485","2147.84848484848","106.606060606061"
"33126","2021",13,13,0,100,0,"200080.769230769","1927.92307692308","106.307692307692"
"33127","2021",6,6,0,100,0,246000,"1457.83333333333","164.166666666667"
"33128","2021",12,12,0,100,0,"152371.583333333","1369.25","119.25"
"33129","2021",2,2,0,100,0,250200,"2125.5","117.5"
"33130","2021",17,17,0,100,0,"310530.882352941","2594.05882352941","121.882352941176"
"33131","2021",6,6,0,100,0,"227733.333333333","2289.5","93.8333333333333"
"33132","2021",13,13,0,100,0,"234523.076923077","1999.84615384615","124.307692307692"
"33133","2021",3,3,0,100,0,"244466.666666667",1696,"157.333333333333"
"33134","2021",2,2,0,100,0,171500,"2092.5","85.5"
"33136","2021",4,4,0,100,0,165325,"1807.25","97.5"
"33137","2021",2,2,0,100,0,112500,1119,100
"33138","2021",161,124,37,"77.0186335403727","22.9813664596273","153330.826086957","1784.3602484472","86.4658385093168"
"33139","2021",2,2,0,100,0,332720,1362,236
"33140","2021",72,55,17,"76.3888888888889","23.6111111111111","211025.180555556","2535.41666666667","84.8472222222222"
"33141","2021",8,8,0,100,0,262820,"2277.75","111.375"
"33142","2021",33,33,0,100,0,"227753.212121212","2316.78787878788","103.939393939394"
"33143","2021",43,39,4,"90.6976744186046","9.30232558139535","221352.511627907","2570.97674418605","93.1162790697674"
"33144","2021",10,10,0,100,0,"339910.8","2220.2","159.7"
"33145","2021",9,9,0,100,0,331150,"2865.66666666667","118.111111111111"
"33146","2021",30,29,1,"96.6666666666667","3.33333333333333","219579.333333333","2057.3","109.466666666667"
"33147","2021",7,7,0,100,0,"208635.714285714",2285,94
"33148","2021",2,2,0,100,0,255000,"1770.5",144
"33149","2021",1,1,0,100,0,455895,1577,289
"33150","2021",3,3,0,100,0,"176243.333333333","1402.33333333333","138.666666666667"
"33151","2021",5,4,1,80,20,161490,1760,"103.8"
"33152","2021",1,1,0,100,0,67000,838,80
"33153","2021",4,4,0,100,0,"152378.5","2171.75",79
"33154","2021",40,37,3,"92.5","7.5","138759.2","1351.65","104.2"
"33155","2021",1,1,0,100,0,181716,1063,171
"33156","2021",3,3,0,100,0,175700,1644,"107.333333333333"
"33157","2021",4,4,0,100,0,237750,2477,"94.75"
"33158","2021",1,1,0,100,0,178000,1978,90
"33159","2021",43,35,8,"81.3953488372093","18.6046511627907","113236.744186047","1204.79069767442","89.4418604651163"
"33160","2021",11,11,0,100,0,"148065.545454545","1398.27272727273","107.818181818182"
"33161","2021",6,6,0,100,0,"146083.333333333","1749.83333333333",98
"33162","2021",416,226,190,"54.3269230769231","45.6730769230769","304781.197115385","3815.07692307692","79.9927884615385"
"33163","2021",4,4,0,100,0,364950,"2809.5",130
"33164","2021",23,23,0,100,0,"270806.956521739","2174.82608695652","119.608695652174"
"33165","2021",54,37,17,"68.5185185185185","31.4814814814815","305525.777777778","3269.24074074074","96.3333333333333"
"33166","2021",4,4,0,100,0,155125,"1650.5","94.25"
"33167","2021",207,107,100,"51.6908212560386","48.3091787439614","251437.096618357","3397.48792270531","76.0966183574879"
"33168","2021",16,16,0,100,0,"242982.8125","1777.4375","135.9375"
"33170","2021",12,12,0,100,0,"170751.25","1579.75","111.416666666667"
"33171","2021",5,5,0,100,0,273587,"1983.8","139.2"
"33172","2021",3,3,0,100,0,"161333.333333333",1458,"98.3333333333333"
"33173","2021",2,2,0,100,0,536000,"3089.5","170.5"
"33174","2021",14,14,0,100,0,"233660.357142857","1583.28571428571","154.071428571429"
"33175","2021",13,13,0,100,0,"185199.076923077","1576.07692307692","118.307692307692"
"33176","2021",2,2,0,100,0,281550,"1534.5",184
"33177","2021",41,40,1,"97.5609756097561","2.4390243902439","218730.634146341","2325.53658536585","100.292682926829"
"33178","2021",2,2,0,100,0,187595,"1901.5",97
"33179","2021",54,45,9,"83.3333333333333","16.6666666666667","179368.444444444","1876.77777777778","97.2407407407407"
"33180","2021",1,1,0,100,0,408000,2147,190
"33181","2021",3,3,0,100,0,"122275.333333333","1431.66666666667",88
"33182","2021",15,15,0,100,0,"298493.333333333","1979.33333333333","129.733333333333"
"33183","2021",20,20,0,100,0,249580,"2241.3","114.1"
"33184","2021",4,4,0,100,0,219325,"973.75","204.5"
"33185","2021",35,24,11,"68.5714285714286","31.4285714285714","205630.657142857",2216,"93.2"
"33186","2021",15,15,0,100,0,"173166.666666667","1339.26666666667","119.666666666667"
"33187","2021",25,17,8,68,32,"142131.72","1605.4","92.32"
"33188","2021",2,2,0,100,0,121500,1068,"161.5"
"33189","2021",11,10,1,"90.9090909090909","9.09090909090909","156710.909090909","2337.54545454545","80.4545454545455"
"33190","2021",2,2,0,100,0,95000,"701.5",125
"33191","2021",6,6,0,100,0,133200,"1370.33333333333","99.8333333333333"
"33192","2021",349,152,197,"43.5530085959885","56.4469914040115","290773.790830946","3774.73638968481","78.458452722063"
"33193","2021",33,33,0,100,0,"234872.727272727","2458.72727272727","101.393939393939"
"33194","2021",7,7,0,100,0,"197428.571428571","1927.71428571429","103.285714285714"
"33195","2021",22,18,4,"81.8181818181818","18.1818181818182","144859.136363636","1601.04545454545","113.909090909091"
"33196","2021",2,2,0,100,0,240000,2884,"83.5"
"33197","2021",6,6,0,100,0,"248896.666666667","2206.16666666667","126.833333333333"
"33198","2021",32,28,4,"87.5","12.5","130992.5625","1612.875","90.0625"
"33199","2021",570,468,102,"82.1052631578947","17.8947368421053","410981.098245614","4551.0701754386","90.9929824561404"
"33200","2021",180,110,70,"61.1111111111111","38.8888888888889","315732.372222222","3903.17777777778","80.9944444444444"
"33201","2021",11,10,1,"90.9090909090909","9.09090909090909","277388.181818182","2567.81818181818","115.818181818182"
"33202","2021",23,21,2,"91.304347826087","8.69565217391304","239302.043478261","2668.73913043478","94.1739130434783"
"33203","2021",124,99,25,"79.8387096774193","20.1612903225806","231749.741935484","3377.36290322581","72.4354838709677"
"33204","2021",6,6,0,100,0,173772,1279,"143.833333333333"
"33205","2021",20,20,0,100,0,"321822.55","2501.3","133.1"
"33206","2021",7,6,1,"85.7142857142857","14.2857142857143","178372.857142857",2260,"84.2857142857143"
"33207","2021",77,74,3,"96.1038961038961","3.8961038961039","286694.337662338","2844.8961038961","104.324675324675"
"33208","2021",29,28,1,"96.551724137931","3.44827586206897","172645.931034483","1568.79310344828","115.896551724138"
"33209","2021",1,1,0,100,0,295000,2269,130
"33210","2021",2,2,0,100,0,196226,"1381.5","127.5"
"33211","2021",10,9,1,90,10,296400,"2862.7","104.7"
"33212","2021",2,2,0,100,0,"180087.5",1357,135
"33213","2021",60,45,15,75,25,"359754.733333333",3456,"106.266666666667"
"33214","2021",324,206,118,"63.5802469135803","36.4197530864198","297758.450617284","4494.69135802469","68.3734567901235"
"33215","2021",1,1,0,100,0,470000,1655,284
"33216","2021",3,3,0,100,0,121500,"1461.66666666667","84.3333333333333"
"33218","2021",13,13,0,100,0,"145430.846153846","1648.46153846154","93.3076923076923"
"33219","2021",31,26,5,"83.8709677419355","16.1290322580645","225608.387096774","2498.93548387097","92.258064516129"
"33220","2021",25,25,0,100,0,240817,"2077.48","119.96"
"33221","2021",15,14,1,"93.3333333333333","6.66666666666667","99480.6666666667","1018.86666666667",101
"33222","2021",8,8,0,100,0,"270618.875","2370.25",119
"33223","2021",5,5,0,100,0,205199,"1610.2","124.2"
"33224","2021",5,5,0,100,0,206100,"1195.2","173.4"
"33225","2021",25,25,0,100,0,"236130.8","2322.92","101.56"
"33226","2021",31,28,3,"90.3225806451613","9.67741935483871","240674.580645161","2445.70967741935","98.6451612903226"
"33227","2021",150,72,78,48,52,"143884.693333333","1947.66","75.8866666666667"
"33228","2021",10,10,0,100,0,265899,"2083.2","124.8"
"33229","2021",169,135,34,"79.8816568047337","20.1183431952663","354684.130177515","4448.55029585799","83.0710059171598"
"33230","2021",6,6,0,100,0,146010,"1822.16666666667","87.5"
"33231","2021",3,3,0,100,0,98500,"1059.33333333333","92.6666666666667"
"33233","2021",35,35,0,100,0,"213233.828571429","1828.45714285714","122.657142857143"
"33234","2021",63,60,3,"95.2380952380952","4.76190476190476","510712.476190476","3848.19047619048","133.079365079365"
"33235","2021",4,4,0,100,0,205480,"1688.5","121.75"
"33236","2021",315,244,71,"77.4603174603175","22.5396825396825","868634.565079365","8684.97142857143","99.3111111111111"
"33237","2021",14,14,0,100,0,"234810.714285714","2258.42857142857","114.857142857143"
"33238","2021",127,118,9,"92.9133858267717","7.08661417322835","423992.37007874","3777.88976377953","111.346456692913"
"33239","2021",9,9,0,100,0,"193788.888888889","1495.22222222222","143.888888888889"
"33240","2021",137,114,23,"83.2116788321168","16.7883211678832","157934.423357664","1723.59854014599","95.0802919708029"
"33241","2021",16,15,1,"93.75","6.25","210198.125","2024.3125","109.5"
"33242","2021",7,7,0,100,0,"156221.428571429","1536.57142857143","103.428571428571"
"33243","2021",540,317,223,"58.7037037037037","41.2962962962963","203291.901851852","2511.84444444444","81.8981481481482"
"33244","2021",1,1,0,100,0,230000,4600,50
"33245","2021",10,10,0,100,0,504190,"3521.3","135.7"
"33247","2021",1,1,0,100,0,159700,1613,99
"33248","2021",68,65,3,"95.5882352941177","4.41176470588235","240667.029411765","2251.16176470588","109.720588235294"
"33249","2021",230,95,135,"41.304347826087","58.695652173913","220788.191304348","2847.36956521739","78.7173913043478"
"33250","2021",5,5,0,100,0,144088,"1370.4","108.8"
"33251","2021",11,11,0,100,0,"239168.545454545","2307.09090909091","105.818181818182"
"33252","2021",10,10,0,100,0,"266499.6","2420.8","114.7"
"33253","2021",7,7,0,100,0,"245121.428571429","1672.57142857143","151.285714285714"
"33254","2021",7,7,0,100,0,"195564.285714286","1968.28571428571","99.8571428571429"
"33255","2021",4,4,0,100,0,"193017.75","1473.5",127
"33256","2021",64,55,9,"85.9375","14.0625","296507.609375","3036.015625","98.921875"
"33257","2021",8,8,0,100,0,250875,"1920.75","126.125"
"33258","2021",2,2,0,100,0,235500,2488,105
"33259","2021",17,15,2,"88.2352941176471","11.7647058823529","189074.411764706","2053.64705882353","94.3529411764706"
"33260","2021",23,23,0,100,0,"308973.47826087","2758.73913043478","123.391304347826"
"33261","2021",16,16,0,100,0,"246397.125","2532.9375","95.9375"
"33262","2021",74,73,1,"98.6486486486486","1.35135135135135","264174.445945946","2883.31081081081","96.4324324324324"
"33263","2021",3,3,0,100,0,"178093.333333333","2500.33333333333","70.6666666666667"
"33264","2021",19,19,0,100,0,"150731.578947368","1666.68421052632",97
"33266","2021",7,7,0,100,0,"239557.142857143","2022.14285714286","121.571428571429"
"33268","2021",37,34,3,"91.8918918918919","8.10810810810811","259012.837837838","2722.81081081081","102.108108108108"
"33269","2021",6,6,0,100,0,275515,"1740.16666666667","156.666666666667"
"33270","2021",3,3,0,100,0,199500,"2551.66666666667",84
"33271","2021",3,3,0,100,0,"206916.666666667","2508.33333333333","86.3333333333333"
"33272","2021",15,15,0,100,0,"224560.2","1981.66666666667","120.4"
"33273","2021",113,77,36,"68.141592920354","31.858407079646","355870.371681416","3733.69911504425","97.8141592920354"
"33274","2021",46,41,5,"89.1304347826087","10.8695652173913","356131.304347826","3393.84782608696","106.217391304348"
"33275","2021",1,1,0,100,0,220000,1038,212
"33277","2021",4,4,0,100,0,"224607.5","1230.75","173.75"
"33278","2021",7,7,0,100,0,"158214.285714286","1516.42857142857","108.857142857143"
"33279","2021",6,6,0,100,0,"194333.333333333","1787.16666666667",107
"33280","2021",6,6,0,100,0,"179166.666666667","1572.33333333333",121
"33281","2021",1203,487,716,"40.4821280133001","59.5178719866999","302678.419783874","3870.38902743142","77.8229426433915"
"33282","2021",3,3,0,100,0,155730,"1236.33333333333",138
"33283","2021",2,2,0,100,0,165485,"1196.5",140
"33284","2021",185,173,12,"93.5135135135135","6.48648648648649","358768.232432432","3578.06486486486","103.243243243243"
"33285","2021",3,3,0,100,0,231650,1973,"125.666666666667"
"33287","2021",8,8,0,100,0,189300,"1662.5","120.875"
"33288","2021",1,1,0,100,0,252200,2449,103
"33289","2021",34,33,1,"97.0588235294118","2.94117647058824","151302.970588235","1296.91176470588","118.647058823529"
"33290","2021",25,25,0,100,0,"358003.48","2390.6","130.6"
"33291","2021",2,2,0,100,0,151500,"1344.5","132.5"
"33292","2021",3,3,0,100,0,108200,"1382.66666666667",90
"33293","2021",68,52,16,"76.4705882352941","23.5294117647059","282576.25","2950.45588235294","100.308823529412"
"33294","2021",7,7,0,100,0,"132957.142857143","1546.28571428571",87
"33296","2021",18,18,0,100,0,"181573.333333333","1599.33333333333","116.111111111111"
"33297","2021",30,30,0,100,0,"257761.633333333","2294.8","111.066666666667"
"33298","2021",13,13,0,100,0,360322,"2976.61538461538","122.538461538462"
"33299","2021",5,5,0,100,0,269310,"1768.2","163.2"
"33300","2021",28,28,0,100,0,"276736.071428571","2684.32142857143","111.964285714286"
"33301","2021",4,4,0,100,0,"265293.75","2547.25","106.5"
"33302","2021",5,5,0,100,0,218040,"2198.8","106.8"
"33303","2021",12,12,0,100,0,"180616.666666667","1942.83333333333","96.25"
"33304","2021",4,4,0,100,0,248700,"1149.75",205
"33305","2021",7,7,0,100,0,"210742.857142857",2034,100
"33306","2021",7,7,0,100,0,"238107.142857143","1360.14285714286","173.428571428571"
"33307","2021",32,32,0,100,0,"220050.59375","1891.0625","123.4375"
"33308","2021",2,2,0,100,0,87500,"1025.5","104.5"
"33309","2021",7,7,0,100,0,"192752.857142857","1500.42857142857","128.857142857143"
"33310","2021",4,4,0,100,0,189250,"1908.75",112
"33311","2021",29,23,6,"79.3103448275862","20.6896551724138","205066.206896552","2013.93103448276","98.8965517241379"
"33312","2021",156,101,55,"64.7435897435898","35.2564102564103","274181.673076923","3383.75","81.0320512820513"
"33314","2021",59,58,1,"98.3050847457627","1.69491525423729","186445.203389831","1878.54237288136","107.966101694915"
"33315","2021",23,23,0,100,0,"182054.347826087","1713.82608695652","113.521739130435"
"33316","2021",14,14,0,100,0,184310,"1292.21428571429","138.142857142857"
"33317","2021",11,11,0,100,0,"204725.181818182","2023.36363636364","104.181818181818"
"33318","2021",877,502,375,"57.2405929304447","42.7594070695553","328071.11972634","4020.73204104903","82.7480045610034"
"33319","2021",4,4,0,100,0,165000,"1629.75",99
"33320","2021",11,11,0,100,0,"211130.909090909","1715.54545454545","121.363636363636"
"33321","2021",14,14,0,100,0,"246790.285714286","2325.35714285714","107.571428571429"
"33322","2021",91,90,1,"98.9010989010989","1.0989010989011","325629.758241758","3080.96703296703","107.967032967033"
"33323","2021",19,19,0,100,0,"255733.684210526","2252.21052631579","121.631578947368"
"33324","2021",93,72,21,"77.4193548387097","22.5806451612903","130701.849462366","1438.34408602151","91.3333333333333"
"33325","2021",12,12,0,100,0,"154196.666666667","1879.16666666667",87
"33326","2021",2,2,0,100,0,63600,932,"91.5"
"33327","2021",38,34,4,"89.4736842105263","10.5263157894737","249473.263157895","2944.05263157895","88.3947368421053"
"33328","2021",6,6,0,100,0,"224198.333333333","2763.16666666667","85.3333333333333"
"33329","2021",8,8,0,100,0,"215812.5","2579.25","93.125"
"33330","2021",33,31,2,"93.9393939393939","6.06060606060606","413614.181818182","3457.81818181818","120.787878787879"
"33331","2021",8,8,0,100,0,"272908.25","3066.625","116.375"
"33332","2021",15,15,0,100,0,139585,"1410.53333333333","102.866666666667"
"33333","2021",39,36,3,"92.3076923076923","7.69230769230769","359011.205128205","3869.71794871795","98.3589743589744"
"33334","2021",35,30,5,"85.7142857142857","14.2857142857143","251758.457142857","2716.68571428571","96.9714285714286"
"33335","2021",9,9,0,100,0,330743,"2947.11111111111","113.666666666667"
"33336","2021",24,24,0,100,0,"171358.583333333","1650.91666666667","107.916666666667"
"33337","2021",39,38,1,"97.4358974358974","2.56410256410256","195998.205128205","1804.02564102564","114.307692307692"
"33339","2021",26,26,0,100,0,"231320.461538462","2333.03846153846","107.115384615385"
"33341","2021",26,26,0,100,0,"222557.192307692","2346.84615384615","94.9615384615385"
"33342","2021",10,10,0,100,0,"216204.5",2084,"103.4"
"33343","2021",10,10,0,100,0,227760,"1887.3","117.2"
"33344","2021",7,7,0,100,0,"260406.571428571","2160.85714285714","120.714285714286"
"33345","2021",6,6,0,100,0,"175818.333333333","1579.33333333333",115
"33346","2021",7,7,0,100,0,"194471.428571429","1400.71428571429","142.714285714286"
"33347","2021",8,8,0,100,0,151550,"1594.25","113.375"
"33348","2021",24,24,0,100,0,"217524.125","1835.16666666667","119.708333333333"
"33349","2021",29,27,2,"93.1034482758621","6.89655172413793","389082.931034483","3558.24137931034","107.48275862069"
"33350","2021",16,14,2,"87.5","12.5","189945.25",2208,"107.0625"
"33351","2021",28,28,0,100,0,"131950.892857143","1542.21428571429","102.821428571429"
"33352","2021",80,67,13,"83.75","16.25","131203.325","1360.9375","97.825"
"33353","2021",4,4,0,100,0,178750,"2932.5","78.25"
"33354","2021",3,3,0,100,0,189000,"1495.66666666667","126.333333333333"
"33355","2021",23,22,1,"95.6521739130435","4.34782608695652","185691.304347826","2110.39130434783","89.9130434782609"
"33356","2021",4,4,0,100,0,"328337.5","2478.25","140.75"
"33357","2021",27,27,0,100,0,"295568.333333333","2462.62962962963","123.222222222222"
"33358","2021",11,11,0,100,0,"260821.818181818","2320.72727272727","113.272727272727"
"33360","2021",8,8,0,100,0,134000,"1153.625","120.5"
"33361","2021",7,7,0,100,0,"179085.714285714","1623.14285714286","116.857142857143"
"33362","2021",18,18,0,100,0,183850,"2098.66666666667",90
"33363","2021",72,70,2,"97.2222222222222","2.77777777777778","329084.444444444","3011.73611111111","113.888888888889"
"33364","2021",4,4,0,100,0,"235637.5",2228,104
"33365","2021",2,2,0,100,0,175000,2020,"86.5"
"33366","2021",209,145,64,"69.377990430622","30.622009569378","206205.889952153","2537.64114832536","82.9186602870813"
"33367","2021",5,5,0,100,0,196900,"1451.6","141.2"
"33369","2021",10,10,0,100,0,248287,"1646.6",148
"33370","2021",7,7,0,100,0,"130213.714285714","1333.85714285714","101.142857142857"
"33372","2021",1,1,0,100,0,239050,1328,180
"33373","2021",14,14,0,100,0,"133298.785714286","1183.64285714286","112.071428571429"
"33374","2021",12,12,0,100,0,"150472.333333333","1201.25","128.25"
"33375","2021",5,5,0,100,0,"246983.6","2234.6","107.2"
"33376","2021",98,91,7,"92.8571428571429","7.14285714285714","469654.12244898","3819.86734693878","122.704081632653"
"33377","2021",3,3,0,100,0,"230366.666666667","1438.66666666667","183.666666666667"
"33378","2021",13,13,0,100,0,"154861.538461538","1463.76923076923","106.230769230769"
"33379","2021",3,3,0,100,0,215350,"1355.33333333333","189.333333333333"
"33380","2021",24,24,0,100,0,"133520.416666667","1280.875","110.916666666667"
"33381","2021",57,47,10,"82.4561403508772","17.5438596491228","272306.105263158","2860.29824561404","95.9649122807018"
"33382","2021",29,29,0,100,0,"206219.310344828","1668.1724137931","130.620689655172"
"33383","2021",14,14,0,100,0,"135234.285714286","1461.71428571429","93.5"
"33384","2021",3,3,0,100,0,"288166.666666667","2750.33333333333","110.333333333333"
"33385","2021",10,10,0,100,0,"169995.6","1441.2","120.4"
"33386","2021",1,1,0,100,0,144726,1477,98
"33387","2021",17,17,0,100,0,"163729.411764706","1754.76470588235","97.8235294117647"
"33388","2021",13,13,0,100,0,"236555.769230769","1646.53846153846","146.230769230769"
"33389","2021",50,48,2,96,4,"149263.8","1298.2","110.26"
"33390","2021",7,7,0,100,0,"287807.142857143","2210.42857142857","131.571428571429"
"33391","2021",4,4,0,100,0,212500,"1893.5",148
"33392","2021",11,11,0,100,0,"151136.363636364","1698.90909090909","92.2727272727273"
"33393","2021",82,76,6,"92.6829268292683","7.31707317073171","201429.158536585","1981.85365853659","105.475609756098"
"33394","2021",27,27,0,100,0,"298116.037037037","3101.25925925926","103.555555555556"
"33395","2021",42,42,0,100,0,"141454.214285714","1476.78571428571","98.1666666666667"
"33396","2021",3,3,0,100,0,"389886.666666667","3150.66666666667",137
"33397","2021",53,49,4,"92.4528301886792","7.54716981132075","291495.075471698","3010.24528301887","98.8490566037736"
"33398","2021",1,1,0,100,0,219000,4380,50
"33399","2021",9,9,0,100,0,"221972.222222222","1568.77777777778",143
"33400","2021",5,5,0,100,0,127600,"1145.8","107.4"
"33401","2021",2,2,0,100,0,186250,2088,96
"33402","2021",54,43,11,"79.6296296296296","20.3703703703704","97209.8518518519","1024.51851851852","100.092592592593"
"33404","2021",3,3,0,100,0,"126777.666666667","1280.33333333333",119
"33405","2021",6,6,0,100,0,"146491.666666667","1218.33333333333","118.5"
"33406","2021",9,9,0,100,0,"596661.111111111","3659.88888888889","133.666666666667"
"33407","2021",9,9,0,100,0,"311910.555555556","2627.11111111111","117.555555555556"
"33408","2021",7,7,0,100,0,"364813.571428571","2735.28571428571","133.571428571429"
"33409","2021",4,4,0,100,0,220250,"1785.5",127
"33411","2021",4,4,0,100,0,"133537.5","1467.25","97.75"
"33412","2021",20,20,0,100,0,"183972.3","1835.75","100.8"
"33413","2021",28,28,0,100,0,332545,"2571.42857142857","137.321428571429"
"33414","2021",8,8,0,100,0,"275515.125","2057.5",130
"33415","2021",41,30,11,"73.1707317073171","26.8292682926829","217332.390243902","2309.31707317073","97.6829268292683"
"33416","2021",14,14,0,100,0,"201011.714285714",1681,"128.714285714286"
"33417","2021",36,33,3,"91.6666666666667","8.33333333333333","267290.583333333","2788.72222222222","102.722222222222"
"33418","2021",3,3,0,100,0,"171533.333333333","1262.66666666667","134.333333333333"
"33419","2021",1,1,0,100,0,195000,1773,110
"33421","2021",5,3,2,60,40,"136471.8","1285.6","116.2"
"33422","2021",114,86,28,"75.4385964912281","24.5614035087719","357665.464912281","3656.14912280702","101.850877192982"
"33423","2021",7,7,0,100,0,"148242.857142857","1538.28571428571","96.8571428571429"
"33424","2021",63,50,13,"79.3650793650794","20.6349206349206","188512.857142857","2159.31746031746","88.2539682539683"
"33425","2021",19,19,0,100,0,"269550.736842105","2688.78947368421","111.526315789474"
"33426","2021",2,2,0,100,0,196295,"2136.5","92.5"
"33427","2021",4,4,0,100,0,"209027.75",4410,98
"33429","2021",4,4,0,100,0,184325,"1822.25","110.25"
"33431","2021",5,5,0,100,0,243824,"2546.8","99.4"
"33433","2021",99,89,10,"89.8989898989899","10.1010101010101","277326.505050505","3006.11111111111","95.2020202020202"
"33434","2021",22,18,4,"81.8181818181818","18.1818181818182","190779.727272727","2568.5","77.4090909090909"
"33435","2021",42,19,23,"45.2380952380952","54.7619047619048","133803.571428571","1661.5","83.8333333333333"
"33436","2021",16,16,0,100,0,"238190.375","2434.625","97.125"
"33437","2021",33,33,0,100,0,"220334.636363636",1936,"112.393939393939"
"33438","2021",26,26,0,100,0,"204546.153846154","2093.42307692308","99.6153846153846"
"33439","2021",20,19,1,95,5,"189573.75","1966.75","93.7"
"33440","2021",3,3,0,100,0,239300,1564,"146.666666666667"
"33441","2021",27,22,5,"81.4814814814815","18.5185185185185","124757.666666667","1362.2962962963","91.962962962963"
"33442","2021",8,8,0,100,0,189765,"2242.375",91
"33443","2021",2,2,0,100,0,238650,"1399.5",203
"33444","2021",10,10,0,100,0,170262,"1517.2","115.4"
"33445","2021",6,6,0,100,0,"289542.166666667",2095,"128.166666666667"
"33446","2021",2,2,0,100,0,195000,1371,"132.5"
"33447","2021",48,47,1,"97.9166666666667","2.08333333333333","171323.604166667","1654.0625","112.8125"
"33448","2021",37,37,0,100,0,"357232.054054054","3353.2972972973","107.108108108108"
"33449","2021",465,383,82,"82.3655913978495","17.6344086021505","350633.767741936","3700.37634408602","96.1290322580645"
"33450","2021",6,6,0,100,0,"141940.833333333","1593.66666666667","92.1666666666667"
"33451","2021",8,8,0,100,0,"238181.75","2027.25","116.875"
"33452","2021",9,9,0,100,0,"257620.555555556","2773.11111111111","99.2222222222222"
"33453","2021",4,4,0,100,0,"255483.75",1751,"151.5"
"33454","2021",18,18,0,100,0,"365352.777777778","2894.33333333333","129.833333333333"
"33456","2021",10,10,0,100,0,"133824.2","1272.8","129.3"
"33457","2021",11,11,0,100,0,"219386.363636364","2075.18181818182","107.454545454545"
"33458","2021",13,13,0,100,0,"175178.230769231","1728.76923076923","98.7692307692308"
"33459","2021",3,3,0,100,0,"227666.666666667","1935.66666666667","108.666666666667"
"33460","2021",7,7,0,100,0,"184614.285714286","1792.28571428571","111.285714285714"
"33461","2021",5,5,0,100,0,218850,1685,"129.2"
"33462","2021",5,5,0,100,0,158538,"1418.2","122.4"
"33463","2021",18,18,0,100,0,213825,"2057.88888888889","108.666666666667"
"33464","2021",6,6,0,100,0,"238705.5","2182.5","110.5"
"33465","2021",12,12,0,100,0,"262739.75","1842.83333333333","144.833333333333"
"33466","2021",99,38,61,"38.3838383838384","61.6161616161616","148761.393939394","2198.58585858586","66.7676767676768"
"33467","2021",6,6,0,100,0,"207717.666666667","1571.83333333333","116.666666666667"
"33468","2021",4,4,0,100,0,92100,"1013.5","91.5"
"33470","2021",9,9,0,100,0,"324170.444444444","2486.77777777778","147.111111111111"
"33471","2021",22,22,0,100,0,"180274.045454545","1832.04545454545","100.727272727273"
"33472","2021",8,8,0,100,0,"143081.25","1564.75",92
"33473","2021",51,48,3,"94.1176470588235","5.88235294117647","168753.725490196","1901.07843137255","96.0196078431373"
"33474","2021",63,63,0,100,0,"346931.80952381","3254.39682539683","110.634920634921"
"33475","2021",5,5,0,100,0,255748,"2127.2","131.4"
"33476","2021",9,9,0,100,0,"92944.4444444444",1060,"91.2222222222222"
"33477","2021",15,15,0,100,0,"166152.2","1585.53333333333","106.333333333333"
"33478","2021",82,72,10,"87.8048780487805","12.1951219512195","135636.56097561","1589.51219512195","86.390243902439"
"33479","2021",5,5,0,100,0,158900,"1200.4","135.8"
"33480","2021",15,15,0,100,0,"463193.333333333","3027.8","131.666666666667"
"33481","2021",4,4,0,100,0,"190687.5","1832.75","109.25"
"33482","2021",3,3,0,100,0,"230133.333333333","1993.66666666667","116.666666666667"
"33483","2021",50,50,0,100,0,335638,"2824.48","122.92"
"33484","2021",24,23,1,"95.8333333333333","4.16666666666667",176950,"1841.16666666667","100.916666666667"
"33485","2021",21,21,0,100,0,"232584.333333333","1992.52380952381","115.666666666667"
"33486","2021",8,8,0,100,0,"190326.625",1810,"106.625"
"33487","2021",12,12,0,100,0,187650,"2142.83333333333",93
"33488","2021",8,8,0,100,0,"248941.875","1905.625","131.375"
"33489","2021",3,3,0,100,0,311195,"2438.66666666667","144.666666666667"
"33490","2021",43,41,2,"95.3488372093023","4.65116279069767","177290.651162791","2182.25581395349","86.5813953488372"
"33491","2021",7,7,0,100,0,"234150.857142857","1531.85714285714","161.571428571429"
"33492","2021",38,32,6,"84.2105263157895","15.7894736842105","175713.763157895","1898.86842105263","91.5"
"33493","2021",10,10,0,100,0,"152370.2","1723.8","101.9"
"33494","2021",18,18,0,100,0,"410502.888888889","3664.16666666667","115.666666666667"
"33496","2021",35,34,1,"97.1428571428571","2.85714285714286","408056.971428571","3298.2","130.2"
"33498","2021",129,122,7,"94.5736434108527","5.42635658914729","309662.263565891","2985.01550387597","108.503875968992"
"33499","2021",7,7,0,100,0,"119428.571428571","1163.14285714286","102.285714285714"
"33500","2021",9,9,0,100,0,184750,"1544.44444444444","124.222222222222"
"33501","2021",46,45,1,"97.8260869565217","2.17391304347826","333576.934782609","3141.54347826087","109.173913043478"
"33502","2021",6,6,0,100,0,"161898.333333333","1518.5","110.833333333333"
"33503","2021",6,6,0,100,0,"336781.666666667","3078.66666666667","111.166666666667"
"33504","2021",17,17,0,100,0,"248598.823529412","1621.11764705882","150.117647058824"
"33505","2021",26,26,0,100,0,"259536.538461538","2585.03846153846","102.192307692308"
"33506","2021",24,19,5,"79.1666666666667","20.8333333333333","145598.75","1412.91666666667","103.833333333333"
"33507","2021",3,3,0,100,0,"162333.333333333","1985.66666666667",80
"33508","2021",9,9,0,100,0,"269636.555555556",2028,"133.444444444444"
"33509","2021",10,10,0,100,0,260187,"1986.8","127.7"
"33510","2021",4,4,0,100,0,185925,"1775.5","120.25"
"33511","2021",10,10,0,100,0,195570,"1771.6","128.2"
"33512","2021",5,5,0,100,0,142300,"1193.6","118.4"
"33513","2021",2,2,0,100,0,159315,"1898.5",81
"33514","2021",191,120,71,"62.82722513089","37.17277486911","221418.32460733","3474.87958115183","67.455497382199"
"33515","2021",4,4,0,100,0,"198542.5",1260,"154.5"
"33516","2021",3,3,0,100,0,"234666.666666667","1411.33333333333",170
"33517","2021",32,31,1,"96.875","3.125","223528.15625","2263.21875","99.5625"
"33518","2021",19,19,0,100,0,"292848.684210526","2530.05263157895","121.842105263158"
"33519","2021",132,114,18,"86.3636363636364","13.6363636363636","367915.446969697","3659.37878787879","103.689393939394"
"33520","2021",6,6,0,100,0,"139894.166666667","1304.16666666667","116.666666666667"
"33521","2021",15,14,1,"93.3333333333333","6.66666666666667","211006.666666667","1929.6","104.866666666667"
"33522","2021",688,294,394,"42.7325581395349","57.2674418604651","307942.713662791","4354.51308139535","71.3241279069767"
"33523","2021",20,17,3,85,15,"184595.55","2057.6","97.45"
"33524","2021",2,2,0,100,0,316915,"2744.5","118.5"
"33525","2021",29,29,0,100,0,"203124.137931034","1979.68965517241","109.413793103448"
"33526","2021",1,1,0,100,0,198920,1913,104
"33527","2021",174,111,63,"63.7931034482759","36.2068965517241","324140.448275862","4024.64942528736","83.6724137931034"
"33528","2021",4,4,0,100,0,"296087.5",3631,91
"33529","2021",644,457,187,"70.9627329192547","29.0372670807453","528432.121118012","5563.44409937888","90.6878881987578"
"33530","2021",10,10,0,100,0,201687,"1809.1","113.2"
"33531","2021",7,7,0,100,0,"248928.571428571","2025.28571428571","141.571428571429"
"33532","2021",5,5,0,100,0,223064,1884,"119.4"
"33533","2021",41,39,2,"95.1219512195122","4.8780487804878","182919.048780488","1979.31707317073","92.9268292682927"
"33534","2021",16,15,1,"93.75","6.25","247971.4375","2514.25","105.125"
"33535","2021",47,45,2,"95.7446808510638","4.25531914893617","387242.29787234","3526.68085106383","112.021276595745"
"33536","2021",8,8,0,100,0,253355,"2023.375","129.125"
"33537","2021",7,7,0,100,0,"314911.428571429","1867.14285714286","137.428571428571"
"33538","2021",15,15,0,100,0,"208013.533333333","1788.06666666667","128.266666666667"
"33539","2021",54,50,4,"92.5925925925926","7.40740740740741","272092.925925926","2672.22222222222","104.703703703704"
"33540","2021",56,53,3,"94.6428571428571","5.35714285714286","235185.892857143","3128.21428571429","83.4285714285714"
"33541","2021",24,23,1,"95.8333333333333","4.16666666666667","246930.208333333","2667.25","98.7916666666667"
"33542","2021",11,11,0,100,0,"304557.363636364","2505.18181818182","117.636363636364"
"33543","2021",20,18,2,90,10,"200210.05","1741.9","121.9"
"33544","2021",94,31,63,"32.9787234042553","67.0212765957447","125582.574468085","2117.98936170213","58.7765957446809"
"33545","2021",15,15,0,100,0,"220389.666666667","2009.53333333333","120.066666666667"
"33546","2021",2,2,0,100,0,195000,"2670.5","82.5"
"33547","2021",16,15,1,"93.75","6.25","193328.125","1834.875","105.125"
"33548","2021",19,18,1,"94.7368421052632","5.26315789473684","247402.315789474","2255.21052631579","112.684210526316"
"33549","2021",2,2,0,100,0,187345,"2650.5","75.5"
"33550","2021",565,352,213,"62.3008849557522","37.6991150442478","294236.789380531","3673.7610619469","80.8849557522124"
"33551","2021",8,7,1,"87.5","12.5","191522.5","1586.875","125.625"
"33552","2021",9,9,0,100,0,"259422.222222222","2828.55555555556","101.444444444444"
"33553","2021",17,17,0,100,0,"203658.647058824","2217.94117647059","92.8235294117647"
"33554","2021",39,27,12,"69.2307692307692","30.7692307692308","328359.230769231","3059.53846153846","104.923076923077"
"33555","2021",88,69,19,"78.4090909090909","21.5909090909091","288652.102272727","3295.57954545455","89.375"
"33001","2022",21,21,0,100,0,"204850.380952381","1879.71428571429","118.619047619048"
"33002","2022",12,12,0,100,0,164452,"1521.5","110.833333333333"
"33003","2022",209,167,42,"79.9043062200957","20.0956937799043","258466.827751196","2993.13875598086","87.9090909090909"
"33004","2022",44,28,16,"63.6363636363636","36.3636363636364","175888.045454545","2309.25","82.5227272727273"
"33005","2022",302,230,72,"76.158940397351","23.841059602649","492934.625827815","5946.11920529801","88.2317880794702"
"33006","2022",16,16,0,100,0,130075,"1399.5625","106.25"
"33007","2022",20,19,1,95,5,"276525.9","2794.25","100.95"
"33008","2022",4,4,0,100,0,320109,"2763.75",119
"33009","2022",534,151,383,"28.2771535580524","71.7228464419476","558332.722846442","8356.10674157303","65.9700374531835"
"33010","2022",11,11,0,100,0,"248647.272727273","2777.90909090909","92.9090909090909"
"33011","2022",141,108,33,"76.5957446808511","23.4042553191489","412910.638297872","5306.91489361702","81.936170212766"
"33012","2022",48,47,1,"97.9166666666667","2.08333333333333","352475.729166667","3490.5","109.333333333333"
"33013","2022",116,78,38,"67.2413793103448","32.7586206896552","305403.137931034","3534.8275862069","86.5603448275862"
"33014","2022",11,11,0,100,0,"300926.363636364","2212.72727272727","132.363636363636"
"33015","2022",17,17,0,100,0,"277006.058823529","2831.58823529412","101.470588235294"
"33016","2022",13,13,0,100,0,"255553.846153846","2620.61538461538","103.384615384615"
"33017","2022",7,7,0,100,0,"255256.285714286","2063.57142857143","119.714285714286"
"33018","2022",44,39,5,"88.6363636363636","11.3636363636364","268269.590909091","2635.22727272727","105.704545454545"
"33019","2022",188,117,71,"62.2340425531915","37.7659574468085","333158.803191489","4039.57446808511","83.5904255319149"
"33020","2022",1,1,0,100,0,185250,1065,174
"33021","2022",16,16,0,100,0,247935,"1889.5","134.125"
"33022","2022",36,34,2,"94.4444444444444","5.55555555555556","310814.166666667",3254,"97.4166666666667"
"33023","2022",17,17,0,100,0,"352051.764705882",3145,"115.117647058824"
"33024","2022",6,6,0,100,0,"233983.333333333","1956.16666666667","134.666666666667"
"33025","2022",5,5,0,100,0,254330,1720,"142.4"
"33026","2022",5,5,0,100,0,139640,"1407.4",131
"33027","2022",5,5,0,100,0,143670,"921.8","142.4"
"33028","2022",9,9,0,100,0,221795,"2043.55555555556","113.888888888889"
"33029","2022",67,57,10,"85.0746268656716","14.9253731343284","327667.656716418","3498.59701492537","95.5223880597015"
"33030","2022",31,26,5,"83.8709677419355","16.1290322580645","203964.516129032","1985.93548387097","111.41935483871"
"33031","2022",1,1,0,100,0,410000,1530,268
"33032","2022",95,46,49,"48.4210526315789","51.5789473684211","226643.694736842","3148.09473684211","74.0947368421053"
"33033","2022",17,16,1,"94.1176470588235","5.88235294117647","345038.235294118",3043,114
"33034","2022",11,11,0,100,0,"281211.090909091","2033.90909090909",126
"33035","2022",16,16,0,100,0,"196760.625","2018.875","98.3125"
"33036","2022",77,73,4,"94.8051948051948","5.19480519480519","245580.675324675","2413.98701298701","111.480519480519"
"33037","2022",32,30,2,"93.75","6.25","329704.6875","3129.53125","106.40625"
"33038","2022",12,12,0,100,0,"189921.666666667",1796,"126.75"
"33039","2022",574,250,324,"43.5540069686411","56.4459930313589","275353.369337979","3982.46341463415","69.8205574912892"
"33040","2022",11,11,0,100,0,"236416.545454545","2642.18181818182","90.1818181818182"
"33042","2022",96,91,5,"94.7916666666667","5.20833333333333","299370.260416667","2952.40625","104.208333333333"
"33043","2022",3,3,0,100,0,"193252.333333333","1888.66666666667",104
"33044","2022",2,2,0,100,0,204975,"2876.5","71.5"
"33045","2022",1,1,0,100,0,72000,847,85
"33046","2022",10,10,0,100,0,"298443.2","2090.2","139.3"
"33047","2022",23,23,0,100,0,"189918.260869565","1810.34782608696","112.652173913043"
"33048","2022",2,2,0,100,0,"203199.5",2017,103
"33049","2022",28,28,0,100,0,"345092.964285714","3156.92857142857","112.285714285714"
"33050","2022",8,8,0,100,0,"248121.75","2018.75","129.625"
"33051","2022",198,155,43,"78.2828282828283","21.7171717171717","333181.454545455","3928.35858585859","87.979797979798"
"33052","2022",18,13,5,"72.2222222222222","27.7777777777778","205628.166666667",2355,"85.3333333333333"
"33053","2022",4,4,0,100,0,"279262.5","2105.5","132.5"
"33054","2022",5,5,0,100,0,190860,"1859.6","103.2"
"33055","2022",2,2,0,100,0,167500,"2128.5","83.5"
"33056","2022",198,125,73,"63.1313131313131","36.8686868686869","340450.101010101","3828.4595959596","89.7878787878788"
"33057","2022",12,11,1,"91.6666666666667","8.33333333333333","221371.25","1779.83333333333","124.25"
"33058","2022",98,71,27,"72.4489795918367","27.5510204081633","138350.571428571","1718.77551020408","83.0816326530612"
"33059","2022",3,3,0,100,0,271050,"2057.33333333333","132.666666666667"
"33060","2022",9,9,0,100,0,210865,"2718.77777777778","96.5555555555556"
"33061","2022",18,18,0,100,0,"473863.777777778",3876,"127.777777777778"
"33062","2022",8,8,0,100,0,"162618.75","1709.125","95.875"
"33063","2022",5539,1396,4143,"25.2031052536559","74.7968947463441","360913.133959198","5040.47048203647","72.1009207438166"
"33065","2022",29,28,1,"96.551724137931","3.44827586206897","609893.413793103","4618.58620689655","132.793103448276"
"33066","2022",1,1,0,100,0,216000,2000,108
"33067","2022",37,34,3,"91.8918918918919","8.10810810810811","198883.216216216","2015.54054054054","102.432432432432"
"33068","2022",1,1,0,100,0,311800,3118,100
"33069","2022",567,261,306,"46.031746031746","53.968253968254","439521.795414462","4981.61904761905","84.9312169312169"
"33070","2022",7,7,0,100,0,"336598.571428571",3468,"97.7142857142857"
"33071","2022",22,20,2,"90.9090909090909","9.09090909090909","211158.954545455","2132.31818181818","97.9545454545455"
"33072","2022",1,1,0,100,0,300000,2439,123
"33073","2022",20,20,0,100,0,"156120.05","1207.4","130.8"
"33074","2022",2,2,0,100,0,243925,"1798.5",138
"33075","2022",377,133,244,"35.2785145888594","64.7214854111406","314666.24137931","4029.03448275862","76.395225464191"
"33076","2022",8,8,0,100,0,172025,"1931.625","91.875"
"33077","2022",31,31,0,100,0,"289557.064516129","2885.8064516129","107.483870967742"
"33078","2022",13,13,0,100,0,"195803.846153846","2132.61538461538","97.0769230769231"
"33079","2022",4,4,0,100,0,"350912.5",2579,134
"33080","2022",88,69,19,"78.4090909090909","21.5909090909091","319280.295454545","3764.05681818182","85.2386363636364"
"33081","2022",41,30,11,"73.1707317073171","26.8292682926829","190363.12195122","2293.60975609756","88.3658536585366"
"33082","2022",18,18,0,100,0,"212696.666666667","2467.05555555556","90.5555555555556"
"33083","2022",11,11,0,100,0,"352478.636363636","3172.54545454545","110.818181818182"
"33084","2022",22,18,4,"81.8181818181818","18.1818181818182","337168.636363636","3319.54545454545","103.909090909091"
"33085","2022",33,32,1,"96.969696969697","3.03030303030303","569588.666666667","4974.12121212121","118.818181818182"
"33086","2022",3,3,0,100,0,"253293.333333333",2596,"98.3333333333333"
"33087","2022",5,5,0,100,0,201317,"1764.8",122
"33088","2022",9,9,0,100,0,"214501.111111111","1899.33333333333","119.555555555556"
"33089","2022",6,6,0,100,0,"154798.833333333","1646.5","91.1666666666667"
"33090","2022",56,48,8,"85.7142857142857","14.2857142857143","342064.285714286","3685.53571428571","94.9821428571429"
"33093","2022",7,7,0,100,0,220360,"2817.42857142857","83.5714285714286"
"33094","2022",4,4,0,100,0,"263693.75",1449,"181.75"
"33095","2022",23,23,0,100,0,"125834.826086957","1400.4347826087","92.3478260869565"
"33096","2022",119,82,37,"68.9075630252101","31.0924369747899","288518.672268908","3187.78991596639","91.4453781512605"
"33097","2022",98,58,40,"59.1836734693878","40.8163265306122","244678.510204082","4268.41836734694","62.3469387755102"
"33098","2022",8,8,0,100,0,"235337.5","2226.875","109.25"
"33099","2022",40,38,2,95,5,"453763.2","3895.95","119.875"
"33100","2022",17,17,0,100,0,"278465.882352941","1962.82352941176","128.235294117647"
"33101","2022",23,23,0,100,0,"178503.391304348","1691.04347826087","111.260869565217"
"33102","2022",1,0,1,0,100,80000,800,100
"33103","2022",2,2,0,100,0,"163587.5",1886,86
"33104","2022",82,67,15,"81.7073170731707","18.2926829268293","271863.243902439","3060.30487804878","89.4146341463415"
"33105","2022",4,4,0,100,0,138750,"1175.75","149.5"
"33106","2022",14,14,0,100,0,"191962.142857143",1841,"111.071428571429"
"33108","2022",76,57,19,75,25,"117239.197368421","1296.05263157895","95.0263157894737"
"33109","2022",34,34,0,100,0,"321271.382352941","3186.73529411765","101.382352941176"
"33111","2022",19,19,0,100,0,164900,"1664.57894736842",100
"33112","2022",4,4,0,100,0,428750,"2425.5","182.75"
"33113","2022",3,3,0,100,0,"169572.333333333","1802.33333333333",93
"33114","2022",49,27,22,"55.1020408163265","44.8979591836735","150085.020408163","2073.36734693878","73.3265306122449"
"33115","2022",7,7,0,100,0,189482,"1641.28571428571","117.571428571429"
"33116","2022",6,6,0,100,0,239380,"1792.33333333333","134.333333333333"
"33117","2022",2,2,0,100,0,155950,1621,"96.5"
"33118","2022",25,25,0,100,0,"422698.28","3684.56","113.4"
"33119","2022",411,169,242,"41.1192214111922","58.8807785888078","244217.092457421","3698.03163017032","66.3795620437956"
"33120","2022",26,26,0,100,0,"246702.538461538","2368.15384615385","106.807692307692"
"33121","2022",3,3,0,100,0,"327506.666666667",2060,163
"33122","2022",156,134,22,"85.8974358974359","14.1025641025641","437185.730769231","4291.0641025641","104.461538461538"
"33123","2022",29,29,0,100,0,"264308.068965517","2262.1724137931",120
"33124","2022",4,4,0,100,0,"160562.5","1848.25","77.25"
"33125","2022",34,34,0,100,0,"220270.147058824","2167.64705882353","100.147058823529"
"33126","2022",11,11,0,100,0,"198400.727272727","2084.81818181818","104.727272727273"
"33127","2022",5,5,0,100,0,"170183.4","1901.4","91.6"
"33128","2022",10,10,0,100,0,141384,"1577.9","88.5"
"33129","2022",2,2,0,100,0,201656,"1746.5","121.5"
"33130","2022",14,13,1,"92.8571428571429","7.14285714285714","349904.428571429","2542.85714285714","131.571428571429"
"33131","2022",7,7,0,100,0,"275282.857142857",1989,"146.142857142857"
"33132","2022",6,6,0,100,0,"219666.833333333","2241.66666666667","97.5"
"33133","2022",1,1,0,100,0,510000,3290,155
"33134","2022",6,6,0,100,0,"240231.833333333","1678.5",142
"33135","2022",1,1,0,100,0,205000,2500,82
"33136","2022",5,5,0,100,0,"210780.2","1930.6","113.6"
"33137","2022",7,7,0,100,0,"190546.857142857",1885,111
"33138","2022",135,113,22,"83.7037037037037","16.2962962962963","174097.6","1885.42962962963","92.2148148148148"
"33139","2022",2,2,0,100,0,149000,1461,"98.5"
"33140","2022",86,73,13,"84.8837209302326","15.1162790697674","253394.779069767","2945.79069767442","89.6976744186046"
"33141","2022",7,7,0,100,0,358590,"3662.14285714286","98.8571428571429"
"33142","2022",31,31,0,100,0,"239873.451612903","2314.1935483871","105.709677419355"
"33143","2022",40,37,3,"92.5","7.5","222755.975","2350.15","93.375"
"33144","2022",9,9,0,100,0,"246527.777777778","2280.88888888889","112.333333333333"
"33145","2022",15,13,2,"86.6666666666667","13.3333333333333",300959,"2470.73333333333","124.733333333333"
"33146","2022",41,41,0,100,0,"216368.902439024",2017,"108.878048780488"
"33147","2022",6,6,0,100,0,235455,"2140.66666666667","108.5"
"33148","2022",1,1,0,100,0,91500,769,119
"33150","2022",3,3,0,100,0,"188666.666666667",1971,102
"33151","2022",11,11,0,100,0,"147126.363636364","1422.36363636364","110.454545454545"
"33152","2022",1,1,0,100,0,148000,2056,72
"33153","2022",1,1,0,100,0,118000,1073,110
"33154","2022",31,30,1,"96.7741935483871","3.2258064516129","125725.548387097","1470.12903225806","91.7096774193548"
"33155","2022",3,3,0,100,0,173960,1872,"93.6666666666667"
"33156","2022",2,2,0,100,0,249750,"2211.5","117.5"
"33157","2022",9,9,0,100,0,"306744.444444444","2524.22222222222","123.888888888889"
"33159","2022",33,28,5,"84.8484848484848","15.1515151515152","126342.424242424","1536.42424242424",78
"33160","2022",10,10,0,100,0,"151789.7","1532.3","109.2"
"33161","2022",13,13,0,100,0,"156986.153846154","1592.46153846154","105.384615384615"
"33162","2022",389,210,179,"53.9845758354756","46.0154241645244","320625.809768638","3919.0822622108","80.6118251928021"
"33163","2022",4,4,0,100,0,"279022.5","2558.25","113.75"
"33164","2022",21,21,0,100,0,"235970.619047619","2515.71428571429","96.6666666666667"
"33165","2022",61,28,33,"45.9016393442623","54.0983606557377","255157.098360656","3439.16393442623","74.2786885245902"
"33166","2022",8,8,0,100,0,"176568.75","1490.25","128.125"
"33167","2022",241,120,121,"49.792531120332","50.207468879668","261897.029045643","3502.02904564315","77.103734439834"
"33168","2022",10,10,0,100,0,179388,"2067.2","84.1"
"33170","2022",5,5,0,100,0,256760,1819,"146.4"
"33171","2022",3,3,0,100,0,"198333.333333333","1185.66666666667","155.333333333333"
"33172","2022",1,1,0,100,0,170000,2179,78
"33173","2022",2,2,0,100,0,162500,1074,"125.5"
"33174","2022",13,13,0,100,0,"311901.538461538","2231.76923076923","132.615384615385"
"33175","2022",9,9,0,100,0,"234733.333333333","1766.33333333333","133.111111111111"
"33176","2022",4,4,0,100,0,179375,"1651.25","98.25"
"33177","2022",37,36,1,"97.2972972972973","2.7027027027027","222438.108108108","2342.43243243243","100.513513513514"
"33178","2022",5,5,0,100,0,"324025.6","2297.2",149
"33179","2022",48,38,10,"79.1666666666667","20.8333333333333","204868.4375","2331.47916666667","85.9583333333333"
"33180","2022",2,2,0,100,0,375000,"3689.5","117.5"
"33181","2022",6,6,0,100,0,214575,2210,"106.333333333333"
"33182","2022",15,15,0,100,0,"202421.333333333","1904.53333333333","127.8"
"33183","2022",20,20,0,100,0,"257359.25","2733.8","95.4"
"33184","2022",8,8,0,100,0,"184662.5",1831,"97.875"
"33185","2022",35,27,8,"77.1428571428572","22.8571428571429","275293.628571429","2639.05714285714","102.342857142857"
"33186","2022",16,16,0,100,0,157875,"1326.25","121.875"
"33187","2022",24,15,9,"62.5","37.5","132893.958333333","1537.91666666667","89.9583333333333"
"33188","2022",3,3,0,100,0,223400,"2041.33333333333",114
"33189","2022",4,3,1,75,25,196660,"1421.5","143.25"
"33190","2022",4,4,0,100,0,105625,"1029.75","115.5"
"33191","2022",7,7,0,100,0,"140471.428571429","1647.85714285714","84.8571428571429"
"33192","2022",398,164,234,"41.2060301507538","58.7939698492462","288604.095477387","3875.06783919598","75.7060301507538"
"33193","2022",24,24,0,100,0,278702,"2855.75","100.416666666667"
"33194","2022",11,11,0,100,0,"191789.272727273","1752.18181818182","116.727272727273"
"33195","2022",22,20,2,"90.9090909090909","9.09090909090909","173983.363636364","1876.36363636364","96.9090909090909"
"33196","2022",4,4,0,100,0,"278287.5","2617.5",106
"33197","2022",9,9,0,100,0,"188794.444444444","1728.22222222222",112
"33198","2022",31,30,1,"96.7741935483871","3.2258064516129","176559.677419355","1917.45161290323","95.0967741935484"
"33199","2022",487,357,130,"73.305954825462","26.694045174538","438601.786447639","5148.06160164271","84.5852156057495"
"33200","2022",203,99,104,"48.7684729064039","51.2315270935961","295667.960591133","3880.0197044335","77.3448275862069"
"33201","2022",12,10,2,"83.3333333333333","16.6666666666667","277066.666666667","2750.16666666667","105.083333333333"
"33202","2022",19,19,0,100,0,"275555.368421053","2702.57894736842","103.894736842105"
"33203","2022",128,90,38,"70.3125","29.6875","244127.984375","3735.2265625","67.953125"
"33204","2022",10,9,1,90,10,127550,1532,"90.6"
"33205","2022",18,17,1,"94.4444444444444","5.55555555555556","231686.111111111",2987,"95.7777777777778"
"33206","2022",14,14,0,100,0,"311499.714285714","2943.14285714286","107.071428571429"
"33207","2022",89,85,4,"95.5056179775281","4.49438202247191","281422.348314607","3130.55056179775","92.0112359550562"
"33208","2022",26,26,0,100,0,"175233.230769231","2097.61538461538","90.1538461538462"
"33209","2022",7,7,0,100,0,"265101.428571429","2706.57142857143","117.571428571429"
"33211","2022",4,4,0,100,0,168675,2147,93
"33212","2022",2,2,0,100,0,250000,"2552.5","93.5"
"33213","2022",53,41,12,"77.3584905660377","22.6415094339623","355549.245283019","3737.09433962264","95.5283018867924"
"33214","2022",260,180,80,"69.2307692307692","30.7692307692308","335259.107692308","5220.5","67.1846153846154"
"33215","2022",1,1,0,100,0,235000,1911,123
"33216","2022",1,1,0,100,0,239000,2173,110
"33218","2022",19,19,0,100,0,212506,"1828.31578947368","121.842105263158"
"33219","2022",29,27,2,"93.1034482758621","6.89655172413793","227989.655172414","2492.24137931034","92.9310344827586"
"33220","2022",22,22,0,100,0,221480,"2346.59090909091","91.7272727272727"
"33221","2022",7,7,0,100,0,127269,"1301.85714285714","97.2857142857143"
"33222","2022",6,6,0,100,0,212440,"2050.33333333333","104.5"
"33223","2022",2,2,0,100,0,134000,"1348.5","98.5"
"33224","2022",2,2,0,100,0,248725,"2159.5","109.5"
"33225","2022",33,31,2,"93.9393939393939","6.06060606060606","259956.727272727","2334.66666666667","112.454545454545"
"33226","2022",43,35,8,"81.3953488372093","18.6046511627907","245407.976744186","2341.79069767442","108.906976744186"
"33227","2022",162,81,81,50,50,"170688.37654321","2185.22839506173","79.5123456790123"
"33228","2022",7,7,0,100,0,"202657.142857143","1520.71428571429",129
"33229","2022",162,115,47,"70.9876543209877","29.0123456790123","403259.641975309","5053.61111111111","80.9444444444444"
"33230","2022",4,4,0,100,0,198975,"1764.25","118.25"
"33232","2022",2,2,0,100,0,175500,1508,"119.5"
"33233","2022",39,37,2,"94.8717948717949","5.12820512820513","211161.282051282","1916.10256410256","113.487179487179"
"33234","2022",53,46,7,"86.7924528301887","13.2075471698113","455613.943396226",4151,"112.037735849057"
"33235","2022",4,4,0,100,0,196250,1413,138
"33236","2022",228,172,56,"75.4385964912281","24.5614035087719","917114.807017544","9577.22368421053","95.7017543859649"
"33237","2022",13,13,0,100,0,"245256.153846154","2284.61538461538","107.769230769231"
"33238","2022",116,114,2,"98.2758620689655","1.72413793103448","395881.413793103","3964.48275862069","103.362068965517"
"33239","2022",8,8,0,100,0,"245368.75","2587.75","104.125"
"33240","2022",125,84,41,"67.2","32.8","156418.52","1789.072","88.52"
"33241","2022",4,4,0,100,0,"238089.75","2718.25",92
"33242","2022",5,5,0,100,0,246607,1590,158
"33243","2022",472,283,189,"59.9576271186441","40.0423728813559","225246.029661017","2722.29449152542","82.7457627118644"
"33244","2022",4,4,0,100,0,310826,"3004.5",102
"33245","2022",9,9,0,100,0,"450294.444444444","4280.55555555556",112
"33246","2022",3,3,0,100,0,188000,"1564.33333333333","125.666666666667"
"33247","2022",2,2,0,100,0,217750,2284,93
"33248","2022",44,44,0,100,0,"238240.568181818","2497.86363636364","96.4545454545455"
"33249","2022",232,90,142,"38.7931034482759","61.2068965517241","219797.918103448","2894.40086206897","75.926724137931"
"33250","2022",3,3,0,100,0,"193666.666666667","1319.66666666667","144.666666666667"
"33251","2022",7,6,1,"85.7142857142857","14.2857142857143","270255.714285714","2585.28571428571","110.714285714286"
"33252","2022",6,6,0,100,0,"315441.666666667","3266.83333333333","95.6666666666667"
"33253","2022",17,17,0,100,0,"255504.117647059","2218.05882352941","116.529411764706"
"33254","2022",6,6,0,100,0,218850,1984,"119.166666666667"
"33255","2022",1,0,1,0,100,100000,1667,60
"33256","2022",58,45,13,"77.5862068965517","22.4137931034483","306424.413793103","3378.39655172414","92.051724137931"
"33257","2022",4,4,0,100,0,123225,"1782.75","71.5"
"33258","2022",5,5,0,100,0,146100,"1388.6","104.4"
"33259","2022",15,13,2,"86.6666666666667","13.3333333333333",226541,"2193.86666666667","107.066666666667"
"33260","2022",15,15,0,100,0,298388,"3317.73333333333","103.133333333333"
"33261","2022",15,15,0,100,0,"196339.333333333",1690,"113.133333333333"
"33262","2022",52,50,2,"96.1538461538462","3.84615384615385","291876.634615385","2981.17307692308","102.365384615385"
"33263","2022",4,4,0,100,0,"360272.5","3433.25","108.75"
"33264","2022",5,5,0,100,0,214878,"1863.2",122
"33266","2022",11,11,0,100,0,"320173.636363636","2297.09090909091","133.636363636364"
"33268","2022",57,56,1,"98.2456140350877","1.75438596491228","257839.473684211","2735.63157894737","97.7543859649123"
"33269","2022",7,7,0,100,0,"186278.571428571","2027.14285714286","109.142857142857"
"33270","2022",1,1,0,100,0,150000,1829,82
"33271","2022",2,2,0,100,0,207500,"2037.5",104
"33272","2022",13,13,0,100,0,"244973.076923077","2184.69230769231",119
"33273","2022",97,70,27,"72.1649484536082","27.8350515463918","363773.432989691","3988.88659793814","92.4226804123711"
"33274","2022",41,37,4,"90.2439024390244","9.75609756097561","408253.170731707","3776.68292682927","110.365853658537"
"33275","2022",2,2,0,100,0,397350,"3878.5",86
"33276","2022",1,1,0,100,0,215000,2263,95
"33277","2022",5,5,0,100,0,243910,"2122.6",101
"33278","2022",2,2,0,100,0,359065,1237,293
"33279","2022",9,9,0,100,0,"239466.666666667","2416.66666666667","101.777777777778"
"33280","2022",2,2,0,100,0,157500,"1462.5",130
"33281","2022",1273,432,841,"33.9355852317361","66.0644147682639","297422.916732129","4049.78161822467","73.7030636292223"
"33282","2022",6,6,0,100,0,160950,"1324.83333333333","120.333333333333"
"33283","2022",3,3,0,100,0,336670,"2296.66666666667","128.333333333333"
"33284","2022",165,153,12,"92.7272727272727","7.27272727272727","415183.072727273","3897.4","107.866666666667"
"33285","2022",10,10,0,100,0,"190901.2","1721.9","118.9"
"33287","2022",9,9,0,100,0,"145209.444444444","1421.66666666667",115
"33288","2022",2,2,0,100,0,158750,2242,77
"33289","2022",24,23,1,"95.8333333333333","4.16666666666667","135431.666666667","1366.625","104.875"
"33290","2022",20,20,0,100,0,286761,"2881.6","107.35"
"33291","2022",2,2,0,100,0,116500,936,136
"33292","2022",1,1,0,100,0,170000,1789,95
"33293","2022",61,42,19,"68.8524590163934","31.1475409836066","278105.590163934",3160,"91.3934426229508"
"33294","2022",6,6,0,100,0,"169451.666666667","1937.5","86.3333333333333"
"33295","2022",1,1,0,100,0,142000,1651,86
"33296","2022",9,9,0,100,0,"250388.888888889","2168.44444444444",117
"33297","2022",33,33,0,100,0,"315269.212121212","2639.51515151515","122.545454545455"
"33298","2022",11,10,1,"90.9090909090909","9.09090909090909","423216.363636364","3734.63636363636","115.818181818182"
"33299","2022",7,7,0,100,0,"181296.428571429","1983.14285714286","101.285714285714"
"33300","2022",19,19,0,100,0,"299188.684210526","3054.52631578947","105.052631578947"
"33301","2022",6,6,0,100,0,"268794.666666667","2340.83333333333","118.833333333333"
"33302","2022",7,7,0,100,0,"317395.714285714","3319.57142857143","104.857142857143"
"33303","2022",8,8,0,100,0,"371387.5",2842,"133.875"
"33304","2022",1,1,0,100,0,340000,3400,100
"33305","2022",6,6,0,100,0,167000,"1641.66666666667","103.166666666667"
"33306","2022",6,6,0,100,0,240570,"2465.83333333333","104.5"
"33307","2022",30,30,0,100,0,239610,"2160.53333333333","119.5"
"33308","2022",2,2,0,100,0,239450,1977,"113.5"
"33309","2022",10,10,0,100,0,"210749.7","2534.5","107.6"
"33310","2022",4,4,0,100,0,345500,"2055.25","172.5"
"33311","2022",22,13,9,"59.0909090909091","40.9090909090909","173060.454545455","2139.5","83.4090909090909"
"33312","2022",135,94,41,"69.6296296296296","30.3703703703704","295913.311111111","3506.78518518519","87.237037037037"
"33314","2022",64,60,4,"93.75","6.25","182512.796875","1976.375","92.734375"
"33315","2022",23,23,0,100,0,"176595.652173913","1684.52173913043","108.347826086957"
"33316","2022",10,10,0,100,0,132545,1504,"103.4"
"33317","2022",16,16,0,100,0,"259461.875","2571.3125","104.5"
"33318","2022",866,501,365,"57.8521939953811","42.1478060046189","346194.830254042","4125.27136258661","84.7944572748268"
"33319","2022",10,10,0,100,0,138170,"1238.2",108
"33320","2022",4,4,0,100,0,237500,"1851.25","149.75"
"33321","2022",15,15,0,100,0,"246517.333333333","2568.26666666667","96.9333333333333"
"33322","2022",81,79,2,"97.5308641975309","2.46913580246914","399889.913580247","3539.56790123457","115.469135802469"
"33323","2022",9,9,0,100,0,"222856.333333333","2182.66666666667","108.111111111111"
"33324","2022",100,55,45,55,45,"120653.59","1412.92","81.69"
"33325","2022",20,20,0,100,0,199440,"1879.1","106.5"
"33326","2022",2,2,0,100,0,155000,"1457.5","108.5"
"33327","2022",44,43,1,"97.7272727272727","2.27272727272727","234156.340909091","2577.68181818182","96.0909090909091"
"33328","2022",4,4,0,100,0,208750,2199,"96.5"
"33329","2022",3,3,0,100,0,"144666.666666667","1112.66666666667","122.333333333333"
"33330","2022",52,50,2,"96.1538461538462","3.84615384615385","412845.153846154","3394.19230769231","123.057692307692"
"33331","2022",10,10,0,100,0,191122,"1609.8","127.9"
"33332","2022",8,8,0,100,0,"221189.375","1800.75","121.625"
"33333","2022",30,30,0,100,0,"388282.666666667","3827.73333333333","103.6"
"33334","2022",41,36,5,"87.8048780487805","12.1951219512195",247271,"2893.73170731707","89.9512195121951"
"33335","2022",2,2,0,100,0,321000,4437,80
"33336","2022",22,22,0,100,0,"180879.181818182","2001.13636363636","90.5909090909091"
"33337","2022",39,39,0,100,0,"204140.871794872","2019.02564102564","100.820512820513"
"33339","2022",18,18,0,100,0,"304201.277777778","2442.38888888889","118.166666666667"
"33341","2022",26,26,0,100,0,"230860.653846154","2276.53846153846","106.961538461538"
"33342","2022",12,12,0,100,0,"175544.416666667","1572.08333333333","126.416666666667"
"33343","2022",14,14,0,100,0,"228642.857142857","2353.78571428571","99.9285714285714"
"33344","2022",7,7,0,100,0,"193857.142857143","1692.71428571429","107.857142857143"
"33345","2022",5,5,0,100,0,233250,"2375.6",98
"33346","2022",7,7,0,100,0,"206892.714285714","1572.71428571429","130.714285714286"
"33347","2022",6,6,0,100,0,"140183.333333333","1497.16666666667","99.1666666666667"
"33348","2022",22,22,0,100,0,"192360.090909091","1862.77272727273","102.090909090909"
"33349","2022",24,24,0,100,0,"385694.583333333","3791.16666666667","101.583333333333"
"33350","2022",29,29,0,100,0,"204936.206896552","2027.31034482759","102.448275862069"
"33351","2022",20,20,0,100,0,"143080.05","1464.55","97.4"
"33352","2022",68,61,7,"89.7058823529412","10.2941176470588","145940.205882353","1503.39705882353","96.5294117647059"
"33353","2022",3,3,0,100,0,"208366.666666667","1374.33333333333",143
"33354","2022",1,1,0,100,0,495000,1650,300
"33355","2022",16,16,0,100,0,"229746.25","2101.5","109.625"
"33356","2022",6,6,0,100,0,354175,"2893.83333333333","130.666666666667"
"33357","2022",35,35,0,100,0,"291647.142857143","2518.65714285714","116.257142857143"
"33358","2022",1,1,0,100,0,185000,2202,84
"33359","2022",9,9,0,100,0,258905,"1605.11111111111","178.111111111111"
"33361","2022",8,8,0,100,0,"185548.75","1472.375","133.75"
"33362","2022",11,11,0,100,0,143700,"1558.72727272727","97.2727272727273"
"33363","2022",53,51,2,"96.2264150943396","3.77358490566038","362634.490566038","3459.52830188679","106.660377358491"
"33364","2022",4,4,0,100,0,249950,"1827.75","129.5"
"33365","2022",4,4,0,100,0,274076,"2331.75","116.25"
"33366","2022",237,151,86,"63.7130801687764","36.2869198312236","223620.953586498","2771.45569620253","82.7341772151899"
"33367","2022",3,3,0,100,0,"242563.333333333","2169.66666666667","111.666666666667"
"33369","2022",8,8,0,100,0,"188612.5",1761,"108.875"
"33370","2022",7,7,0,100,0,"169142.857142857","1483.85714285714","113.571428571429"
"33372","2022",1,1,0,100,0,95000,896,106
"33373","2022",10,10,0,100,0,"188137.5","1776.4","101.3"
"33374","2022",6,5,1,"83.3333333333333","16.6666666666667",175875,"1882.83333333333",87
"33375","2022",5,5,0,100,0,242560,1923,"130.2"
"33376","2022",86,74,12,"86.046511627907","13.953488372093","525480.325581395","4356.25581395349","121.197674418605"
"33377","2022",1,1,0,100,0,148000,1383,107
"33378","2022",25,25,0,100,0,"190351.12","1765.8","103.48"
"33379","2022",1,1,0,100,0,131500,2267,58
"33380","2022",20,20,0,100,0,"152778.55","1536.15","105.45"
"33381","2022",48,40,8,"83.3333333333333","16.6666666666667","286036.875","3087.0625","95.2708333333333"
"33382","2022",13,13,0,100,0,"159533.692307692","1618.15384615385","102.846153846154"
"33383","2022",9,9,0,100,0,"206634.444444444","1884.22222222222","114.888888888889"
"33384","2022",2,2,0,100,0,131750,1858,74
"33385","2022",11,11,0,100,0,"160494.545454545","1438.63636363636","109.909090909091"
"33386","2022",4,4,0,100,0,"228274.25","1817.5","123.75"
"33387","2022",20,20,0,100,0,205606,"1910.4","109.9"
"33388","2022",12,12,0,100,0,"226525.416666667","2162.58333333333","114.75"
"33389","2022",38,38,0,100,0,"152973.026315789","1587.42105263158","98.0789473684211"
"33390","2022",5,5,0,100,0,200300,"2066.8","105.8"
"33391","2022",2,2,0,100,0,166250,1483,110
"33392","2022",10,9,1,90,10,"181405.2","1569.1","123.1"
"33393","2022",71,61,10,"85.9154929577465","14.0845070422535","207004.394366197","2091.84507042254","98.8591549295775"
"33394","2022",16,13,3,"81.25","18.75","303565.625","2997.875","114.625"
"33395","2022",34,34,0,100,0,"164008.352941176","1602.58823529412","101.352941176471"
"33396","2022",2,0,2,0,100,38000,"899.5","42.5"
"33397","2022",58,57,1,"98.2758620689655","1.72413793103448","336212.25862069","3134.79310344828","112.120689655172"
"33398","2022",2,2,0,100,0,276785,"1911.5",145
"33399","2022",3,3,0,100,0,"190566.666666667","1748.33333333333",125
"33400","2022",1,1,0,100,0,120000,698,172
"33402","2022",51,39,12,"76.4705882352941","23.5294117647059","103491.294117647","1090.49019607843","96.3921568627451"
"33403","2022",4,4,0,100,0,298250,"3027.75","97.5"
"33405","2022",8,8,0,100,0,"167181.25","1515.375","106.375"
"33406","2022",4,4,0,100,0,230625,"1492.75","159.25"
"33407","2022",10,10,0,100,0,269585,"2614.3","102.5"
"33408","2022",4,4,0,100,0,"597293.5",2486,"191.25"
"33409","2022",3,3,0,100,0,"247466.666666667",1930,"131.333333333333"
"33412","2022",19,19,0,100,0,"221165.842105263","2073.57894736842","106.947368421053"
"33413","2022",24,23,1,"95.8333333333333","4.16666666666667","270988.416666667","2765.95833333333","104.541666666667"
"33414","2022",3,3,0,100,0,"414073.333333333","2889.33333333333",137
"33415","2022",39,34,5,"87.1794871794872","12.8205128205128","257108.846153846","2452.41025641026","104.666666666667"
"33416","2022",16,16,0,100,0,"142004.375","1487.125","94.1875"
"33417","2022",30,29,1,"96.6666666666667","3.33333333333333","340846.466666667","3146.53333333333","110.266666666667"
"33418","2022",4,4,0,100,0,"250337.5","2300.75","125.75"
"33421","2022",8,6,2,75,25,"130717.875","1953.75","64.5"
"33422","2022",120,87,33,"72.5","27.5","387099.25","4111.05",96
"33423","2022",3,3,0,100,0,"170233.333333333","1852.66666666667","100.666666666667"
"33424","2022",74,57,17,"77.027027027027","22.972972972973","213733.22972973","2370.35135135135","88.2027027027027"
"33425","2022",28,28,0,100,0,"263495.428571429","2385.67857142857","111.607142857143"
"33426","2022",8,8,0,100,0,235375,"2677.5","95.375"
"33427","2022",2,2,0,100,0,228500,"2175.5","112.5"
"33428","2022",1,1,0,100,0,240000,1778,135
"33429","2022",4,4,0,100,0,187200,1705,"117.75"
"33431","2022",6,6,0,100,0,"282808.333333333","2803.5","100.666666666667"
"33432","2022",1,1,0,100,0,60000,480,125
"33433","2022",111,102,9,"91.8918918918919","8.10810810810811","322916.045045045","3289.53153153153","105.45045045045"
"33434","2022",36,30,6,"83.3333333333333","16.6666666666667",226910,"2736.02777777778","86.8888888888889"
"33435","2022",37,22,15,"59.4594594594595","40.5405405405405","156351.891891892","2056.43243243243","76.945945945946"
"33436","2022",10,10,0,100,0,"296056.7","2804.5","103.4"
"33437","2022",31,31,0,100,0,"195050.935483871","1900.45161290323","107.451612903226"
"33438","2022",32,31,1,"96.875","3.125","221834.875","2128.4375","108.4375"
"33439","2022",17,16,1,"94.1176470588235","5.88235294117647","221960.647058824","2103.70588235294","106.117647058824"
"33440","2022",1,1,0,100,0,318000,2065,154
"33441","2022",20,12,8,60,40,"133670.5","1653.35","82.7"
"33442","2022",4,4,0,100,0,"246762.5",1900,"132.25"
"33443","2022",1,1,0,100,0,191500,3089,62
"33444","2022",9,9,0,100,0,"183222.222222222","1745.55555555556","104.555555555556"
"33445","2022",10,10,0,100,0,"207135.5","1636.6","130.6"
"33447","2022",52,50,2,"96.1538461538462","3.84615384615385","175166.846153846","1930.19230769231","96.2307692307692"
"33448","2022",42,41,1,"97.6190476190476","2.38095238095238","343692.595238095","3430.95238095238","107.928571428571"
"33449","2022",392,296,96,"75.5102040816327","24.4897959183673",374776,"3964.82142857143","95.1173469387755"
"33450","2022",1,1,0,100,0,122960,1069,115
"33451","2022",10,10,0,100,0,"315612.7","1824.3","168.9"
"33452","2022",10,10,0,100,0,272218,"2795.8",98
"33453","2022",1,1,0,100,0,260000,1130,230
"33454","2022",21,21,0,100,0,"414796.619047619","3469.95238095238","128.47619047619"
"33456","2022",8,8,0,100,0,182445,"2269.375","93.5"
"33457","2022",9,9,0,100,0,"263244.666666667","2283.33333333333","109.888888888889"
"33458","2022",12,11,1,"91.6666666666667","8.33333333333333","207232.666666667","1648.16666666667","118.583333333333"
"33459","2022",1,1,0,100,0,177000,1639,108
"33460","2022",7,7,0,100,0,"542582.428571429",2626,"155.571428571429"
"33461","2022",7,7,0,100,0,"279511.428571429","1905.28571428571","166.714285714286"
"33462","2022",8,8,0,100,0,205560,"1822.5","112.625"
"33463","2022",25,24,1,96,4,"208602.4","2115.2","103.48"
"33464","2022",2,2,0,100,0,249075,"2645.5",93
"33465","2022",7,7,0,100,0,"225157.142857143","2366.71428571429","94.8571428571429"
"33466","2022",76,27,49,"35.5263157894737","64.4736842105263","167385.171052632","2484.88157894737","64.9473684210526"
"33467","2022",5,5,0,100,0,148230,"1228.8","123.2"
"33468","2022",5,5,0,100,0,443440,"2671.4","147.4"
"33470","2022",8,8,0,100,0,"273518.75","2422.5","114.375"
"33471","2022",21,21,0,100,0,"162335.476190476","1805.14285714286","95.3333333333333"
"33472","2022",5,5,0,100,0,210750,"1769.6","119.8"
"33473","2022",54,47,7,"87.037037037037","12.962962962963",183956,"1992.59259259259","101.407407407407"
"33474","2022",38,38,0,100,0,"395080.184210526","3479.05263157895","111.973684210526"
"33475","2022",4,4,0,100,0,"202962.5","2422.5","83.25"
"33476","2022",7,7,0,100,0,"134814.285714286",1275,"140.571428571429"
"33477","2022",14,14,0,100,0,"127035.714285714",1439,"93.1428571428571"
"33478","2022",70,57,13,"81.4285714285714","18.5714285714286","133508.314285714","1677.32857142857","78.8857142857143"
"33479","2022",1,1,0,100,0,208000,1748,119
"33480","2022",14,14,0,100,0,"295568.928571429","2979.64285714286","100.857142857143"
"33481","2022",3,3,0,100,0,"346888.333333333","2392.66666666667",149
"33482","2022",3,3,0,100,0,"185166.666666667","1449.33333333333","135.333333333333"
"33483","2022",56,51,5,"91.0714285714286","8.92857142857143","346659.982142857","2924.89285714286","116.714285714286"
"33484","2022",28,28,0,100,0,"193759.071428571","2141.17857142857","100.571428571429"
"33485","2022",29,29,0,100,0,"210225.862068966","1908.75862068966","110.448275862069"
"33486","2022",7,7,0,100,0,"245469.285714286","2267.42857142857","116.285714285714"
"33487","2022",14,14,0,100,0,"280849.428571429","2635.35714285714","113.5"
"33488","2022",6,6,0,100,0,"288273.333333333","3444.83333333333","87.5"
"33490","2022",44,39,5,"88.6363636363636","11.3636363636364","222776.022727273","2427.22727272727","90.9545454545455"
"33491","2022",3,3,0,100,0,"176849.333333333",1314,"139.333333333333"
"33492","2022",44,33,11,75,25,"170535.318181818","2013.34090909091","84.7045454545455"
"33493","2022",7,7,0,100,0,"151821.428571429","1542.57142857143","101.285714285714"
"33494","2022",12,11,1,"91.6666666666667","8.33333333333333","363566.333333333","3637.08333333333","99.5"
"33496","2022",39,38,1,"97.4358974358974","2.56410256410256","337195.384615385","3133.71794871795","108.25641025641"
"33498","2022",123,111,12,"90.2439024390244","9.75609756097561","322323.682926829","3159.30894308943","104.772357723577"
"33499","2022",1,1,0,100,0,86000,1564,55
"33500","2022",10,10,0,100,0,196247,"1783.1",110
"33501","2022",52,52,0,100,0,"370889.519230769","3275.25","114.269230769231"
"33502","2022",8,8,0,100,0,217125,"1296.75","180.75"
"33503","2022",7,7,0,100,0,"312331.428571429","3472.71428571429","94.7142857142857"
"33504","2022",9,9,0,100,0,"333506.111111111","2504.55555555556","142.888888888889"
"33505","2022",16,16,0,100,0,"229822.8125","2708.5625","93.9375"
"33506","2022",16,14,2,"87.5","12.5","159953.75","1554.8125",105
"33507","2022",3,3,0,100,0,"179166.666666667","1522.66666666667","110.333333333333"
"33508","2022",5,5,0,100,0,204737,"2009.6","108.6"
"33509","2022",9,9,0,100,0,"255106.666666667","2467.33333333333","101.888888888889"
"33510","2022",4,4,0,100,0,"276762.5","2223.25","126.5"
"33511","2022",11,11,0,100,0,242045,"2129.90909090909","113.454545454545"
"33512","2022",5,5,0,100,0,214480,2867,"78.4"
"33514","2022",157,86,71,"54.7770700636943","45.2229299363057","226417.687898089","3484.25477707006","68.0127388535032"
"33515","2022",8,8,0,100,0,"239543.75","1871.25","145.25"
"33516","2022",3,3,0,100,0,"252510.666666667","1826.33333333333",144
"33517","2022",24,24,0,100,0,275346,"2657.79166666667",109
"33518","2022",13,13,0,100,0,"340972.307692308","3505.38461538462","98.3846153846154"
"33519","2022",140,115,25,"82.1428571428571","17.8571428571429","379794.792857143","3857.11428571429","100.107142857143"
"33520","2022",4,4,0,100,0,"118277.5",1000,"120.75"
"33521","2022",17,17,0,100,0,"220275.588235294","2355.29411764706","97.9411764705882"
"33522","2022",764,302,462,"39.5287958115183","60.4712041884817","306361.79973822","4583.85732984293","68.5274869109948"
"33523","2022",29,25,4,"86.2068965517241","13.7931034482759","229365.551724138","2317.75862068966","99.1724137931034"
"33524","2022",2,2,0,100,0,232500,"2624.5","89.5"
"33525","2022",9,9,0,100,0,"199007.222222222","2208.77777777778","92.5555555555556"
"33526","2022",2,2,0,100,0,186500,"2085.5",92
"33527","2022",143,94,49,"65.7342657342657","34.2657342657343","342929.321678322","4360.97902097902","78.8251748251748"
"33528","2022",1,1,0,100,0,435300,4031,108
"33529","2022",600,398,202,"66.3333333333333","33.6666666666667","592900.961666667","6329.53166666667","86.9466666666667"
"33530","2022",7,7,0,100,0,"198485.714285714","2023.57142857143",98
"33531","2022",2,2,0,100,0,297500,2253,"131.5"
"33532","2022",7,7,0,100,0,"242957.857142857",2381,"100.857142857143"
"33533","2022",36,28,8,"77.7777777777778","22.2222222222222","184628.888888889","2224.63888888889","83.2222222222222"
"33534","2022",6,6,0,100,0,"295935.333333333","2957.66666666667","99.6666666666667"
"33535","2022",30,29,1,"96.6666666666667","3.33333333333333","386779.6","3680.96666666667","106.633333333333"
"33536","2022",4,4,0,100,0,386993,"3199.25","131.25"
"33537","2022",3,3,0,100,0,"183833.333333333",1888,"99.6666666666667"
"33538","2022",6,6,0,100,0,"182433.333333333","1733.5","110.166666666667"
"33539","2022",72,66,6,"91.6666666666667","8.33333333333333","260443.763888889","2604.93055555556","103.027777777778"
"33540","2022",61,61,0,100,0,"265472.803278689","3398.85245901639","87.9508196721311"
"33541","2022",27,27,0,100,0,"259596.407407407","2969.55555555556","88.1111111111111"
"33542","2022",5,5,0,100,0,"242589.8","2149.4","124.8"
"33543","2022",23,23,0,100,0,"207791.739130435","2143.82608695652","101.391304347826"
"33544","2022",84,40,44,"47.6190476190476","52.3809523809524","158575.05952381","2625.36904761905","61.6428571428571"
"33545","2022",12,12,0,100,0,"214795.833333333","1863.91666666667","118.666666666667"
"33546","2022",9,9,0,100,0,"195527.777777778","1660.22222222222","124.333333333333"
"33547","2022",11,10,1,"90.9090909090909","9.09090909090909","186536.363636364","2475.36363636364","77.8181818181818"
"33548","2022",16,15,1,"93.75","6.25","238294.125","1869.5625","130.3125"
"33549","2022",2,2,0,100,0,158750,"1191.5","130.5"
"33550","2022",581,369,212,"63.5111876075731","36.4888123924269","308439.234079174","3844.61273666093","81.0912220309811"
"33551","2022",5,5,0,100,0,152900,"1820.6","78.2"
"33552","2022",19,19,0,100,0,"246564.210526316","2509.36842105263","97.3157894736842"
"33553","2022",10,10,0,100,0,270321,"2705.7","100.7"
"33554","2022",42,29,13,"69.0476190476191","30.952380952381","359914.142857143","3507.35714285714","101.095238095238"
"33555","2022",79,54,25,"68.3544303797468","31.6455696202532","299869.265822785","3493.10126582278","86.0759493670886"
"33001","2023",19,19,0,100,0,"162010.736842105",1663,99
"33002","2023",11,11,0,100,0,"224148.181818182","1540.09090909091","163.818181818182"
"33003","2023",149,114,35,"76.510067114094","23.489932885906","247913.375838926","3044.46979865772","84.2147651006711"
"33004","2023",45,19,26,"42.2222222222222","57.7777777777778","129755.311111111","2096.17777777778","63.2666666666667"
"33005","2023",207,157,50,"75.8454106280193","24.1545893719807","503396.096618357","6221.32850241546","83.8260869565217"
"33006","2023",12,12,0,100,0,"138991.583333333","1461.58333333333","104.5"
"33007","2023",12,12,0,100,0,"335268.75","3823.58333333333",85
"33008","2023",4,4,0,100,0,215725,2178,"110.25"
"33009","2023",443,120,323,"27.0880361173815","72.9119638826185","586347.424379232","8755.81264108352","64.9435665914221"
"33010","2023",7,7,0,100,0,339818,"2862.42857142857","129.714285714286"
"33011","2023",103,82,21,"79.6116504854369","20.3883495145631","448825.912621359","5837.88349514563","80.747572815534"
"33012","2023",35,27,8,"77.1428571428572","22.8571428571429","293258.8","3238.57142857143","91.7142857142857"
"33013","2023",81,46,35,"56.7901234567901","43.2098765432099","263905.444444444","3224.77777777778","83.2962962962963"
"33014","2023",9,9,0,100,0,"225722.222222222","2112.88888888889","114.888888888889"
"33015","2023",23,22,1,"95.6521739130435","4.34782608695652","253775.260869565","2471.91304347826","104.260869565217"
"33016","2023",2,2,0,100,0,173500,1682,103
"33017","2023",3,3,0,100,0,"228333.333333333","2235.66666666667",110
"33018","2023",23,19,4,"82.6086956521739","17.3913043478261","214772.869565217","2350.39130434783","100.173913043478"
"33019","2023",132,80,52,"60.6060606060606","39.3939393939394","312733.075757576","4021.31060606061","78.8712121212121"
"33020","2023",3,3,0,100,0,"128766.666666667","1400.66666666667","81.6666666666667"
"33021","2023",9,9,0,100,0,"229586.888888889","2532.66666666667","89.5555555555556"
"33022","2023",41,39,2,"95.1219512195122","4.8780487804878","283406.926829268","2903.85365853659","98.6829268292683"
"33023","2023",14,14,0,100,0,"349078.571428571","3096.21428571429","117.357142857143"
"33024","2023",4,4,0,100,0,225250,"1660.75","140.5"
"33025","2023",2,2,0,100,0,204440,2182,94
"33026","2023",5,5,0,100,0,234780,"3055.4","83.6"
"33027","2023",3,3,0,100,0,173000,"1540.33333333333","120.666666666667"
"33028","2023",10,10,0,100,0,"275278.5","2651.4","101.7"
"33029","2023",53,48,5,"90.5660377358491","9.43396226415094","377738.301886792","3868.69811320755","99.4339622641509"
"33030","2023",32,30,2,"93.75","6.25","220959.53125","2182.15625","102.53125"
"33031","2023",1,1,0,100,0,125000,845,148
"33032","2023",76,43,33,"56.578947368421","43.421052631579","223258.223684211","2939.98684210526","76.6578947368421"
"33033","2023",5,5,0,100,0,"359548.6","4926.2",70
"33034","2023",3,3,0,100,0,"111919.333333333","1453.66666666667","86.6666666666667"
"33035","2023",8,8,0,100,0,178951,"2495.25",74
"33036","2023",49,43,6,"87.7551020408163","12.2448979591837","230289.489795918","2206.02040816327","103.428571428571"
"33037","2023",19,19,0,100,0,"295377.473684211","3115.10526315789","95.5263157894737"
"33038","2023",8,8,0,100,0,182650,"1584.5","110.125"
"33039","2023",429,193,236,"44.988344988345","55.011655011655","286202.244755245","4014.93706293706","71.3729603729604"
"33040","2023",14,14,0,100,0,215760,"2311.28571428571","98.6428571428571"
"33042","2023",75,72,3,96,4,"309613.186666667","3168.46666666667","100.706666666667"
"33043","2023",1,1,0,100,0,300000,2830,106
"33044","2023",3,3,0,100,0,"379116.666666667","2193.33333333333","172.666666666667"
"33045","2023",2,2,0,100,0,362055,"2070.5",161
"33046","2023",18,18,0,100,0,"155996.444444444","1816.38888888889","86.5"
"33047","2023",35,35,0,100,0,"212260.742857143","1688.08571428571","127.8"
"33048","2023",2,2,0,100,0,313700,"3256.5","108.5"
"33049","2023",22,22,0,100,0,"329184.727272727","3460.77272727273","98.6818181818182"
"33050","2023",14,14,0,100,0,"288371.428571429","1978.21428571429","149.928571428571"
"33051","2023",132,108,24,"81.8181818181818","18.1818181818182","307231.287878788","3695.99242424242","87.7121212121212"
"33052","2023",18,11,7,"61.1111111111111","38.8888888888889","213287.111111111","2385.55555555556","89.4444444444444"
"33053","2023",3,3,0,100,0,150600,"1534.33333333333",99
"33055","2023",4,4,0,100,0,"203037.5","1686.5","114.5"
"33056","2023",152,107,45,"70.3947368421053","29.6052631578947","322772.276315789","3594.67763157895","91.625"
"33057","2023",7,7,0,100,0,173850,"1627.71428571429","104.857142857143"
"33058","2023",61,41,20,"67.2131147540984","32.7868852459016","138541.901639344","1766.18032786885","79.7049180327869"
"33059","2023",2,2,0,100,0,280000,2575,"103.5"
"33060","2023",4,4,0,100,0,172900,"1672.25",94
"33061","2023",11,11,0,100,0,"376647.454545455","3272.63636363636","114.818181818182"
"33062","2023",8,8,0,100,0,"301831.25","2473.125",126
"33063","2023",4333,1056,3277,"24.3711054696515","75.6288945303485","336933.728132933","4895.6704361874","68.7770597738288"
"33065","2023",34,30,4,"88.2352941176471","11.7647058823529","525395.264705882","4043.64705882353","124.794117647059"
"33067","2023",39,32,7,"82.051282051282","17.9487179487179","185477.179487179","1818.97435897436","100.25641025641"
"33069","2023",338,170,168,"50.2958579881657","49.7041420118343","430692.763313609","4880.12426035503","85.3047337278107"
"33070","2023",5,5,0,100,0,"298792.8","3534.6","89.2"
"33071","2023",11,11,0,100,0,"236457.909090909","2043.72727272727","127.181818181818"
"33073","2023",11,11,0,100,0,164199,"1673.54545454545","106.818181818182"
"33074","2023",3,3,0,100,0,339480,"1635.66666666667","197.333333333333"
"33075","2023",299,83,216,"27.7591973244147","72.2408026755853","301217.444816053","3889.30100334448","75.8294314381271"
"33076","2023",7,7,0,100,0,"254092.857142857","1815.71428571429","148.428571428571"
"33077","2023",25,25,0,100,0,"309214.8","3131.08","101.48"
"33078","2023",5,5,0,100,0,236800,"1930.2","130.6"
"33080","2023",79,60,19,"75.9493670886076","24.0506329113924","301099.949367089","3812.94936708861","81.3037974683544"
"33081","2023",18,15,3,"83.3333333333333","16.6666666666667","162022.222222222",2126,"77.5"
"33082","2023",15,15,0,100,0,240012,"2287.33333333333","106.866666666667"
"33083","2023",8,8,0,100,0,"281982.5",3115,"91.375"
"33084","2023",13,10,3,"76.9230769230769","23.0769230769231","239857.692307692","3170.07692307692",79
"33085","2023",35,33,2,"94.2857142857143","5.71428571428571","508930.114285714","4026.71428571429","122.714285714286"
"33086","2023",5,5,0,100,0,180012,2060,"86.4"
"33087","2023",3,3,0,100,0,278695,"1044.66666666667",247
"33088","2023",6,6,0,100,0,"132633.333333333","1594.83333333333","83.3333333333333"
"33089","2023",4,4,0,100,0,87575,"1476.75","62.75"
"33090","2023",37,31,6,"83.7837837837838","16.2162162162162","347285.297297297","3799.64864864865","91.8648648648649"
"33093","2023",7,7,0,100,0,"276571.428571429","2968.28571428571","95.7142857142857"
"33094","2023",6,6,0,100,0,"181763.333333333","1516.33333333333","120.833333333333"
"33095","2023",13,13,0,100,0,"112376.923076923",1380,"82.0769230769231"
"33096","2023",78,57,21,"73.0769230769231","26.9230769230769","274823.692307692","3049.11538461538","90.8333333333333"
"33097","2023",71,39,32,"54.9295774647887","45.0704225352113","245984.23943662","4433.04225352113","61.169014084507"
"33098","2023",5,5,0,100,0,161300,"2461.4","64.4"
"33099","2023",39,34,5,"87.1794871794872","12.8205128205128","426074.179487179","3675.41025641026","117.820512820513"
"33100","2023",15,15,0,100,0,"249268.266666667","2308.33333333333","102.2"
"33101","2023",12,12,0,100,0,"161791.333333333","1391.91666666667","116.75"
"33102","2023",4,4,0,100,0,"148532.5","1913.75",94
"33104","2023",63,50,13,"79.3650793650794","20.6349206349206","236104.698412698","2904.26984126984","81.8571428571429"
"33105","2023",1,1,0,100,0,224837,2392,94
"33106","2023",8,8,0,100,0,"186543.75",1789,"105.625"
"33108","2023",50,35,15,70,30,"109643.24","1380.62","81.82"
"33109","2023",30,29,1,"96.6666666666667","3.33333333333333","278299.5","2911.73333333333","101.433333333333"
"33111","2023",8,8,0,100,0,"132275.625","1344.625","105.375"
"33113","2023",2,2,0,100,0,95250,874,109
"33114","2023",48,33,15,"68.75","31.25","180217.270833333","2112.125","90.0416666666667"
"33115","2023",2,2,0,100,0,247975,2191,114
"33116","2023",3,3,0,100,0,"263026.666666667","2624.66666666667",100
"33117","2023",3,3,0,100,0,"179622.333333333",2173,"86.6666666666667"
"33118","2023",20,20,0,100,0,"604645.8","4334.25","139.35"
"33119","2023",340,113,227,"33.2352941176471","66.7647058823529","206338.158823529","3382.97647058824","62.9058823529412"
"33120","2023",29,28,1,"96.551724137931","3.44827586206897","249205.655172414","2435.72413793103","103.758620689655"
"33122","2023",130,121,9,"93.0769230769231","6.92307692307692","450269.230769231","4125.2","112.730769230769"
"33123","2023",23,23,0,100,0,"234193.173913043","2136.04347826087","111.347826086957"
"33124","2023",5,5,0,100,0,176500,"1589.2","106.2"
"33125","2023",26,26,0,100,0,"225610.923076923","2146.46153846154","107.807692307692"
"33126","2023",8,8,0,100,0,"185449.625","1595.25","111.5"
"33127","2023",2,2,0,100,0,230500,2566,88
"33128","2023",11,11,0,100,0,"182299.818181818","1868.45454545455","103.090909090909"
"33130","2023",7,7,0,100,0,"252182.857142857","2169.85714285714","136.428571428571"
"33132","2023",7,7,0,100,0,"189458.428571429",2170,"94.7142857142857"
"33134","2023",8,8,0,100,0,"199500.5",1534,"141.25"
"33136","2023",4,4,0,100,0,231500,"1926.25",118
"33137","2023",4,4,0,100,0,195560,"1575.75","119.75"
"33138","2023",127,99,28,"77.9527559055118","22.0472440944882","166419.25984252","2011.23622047244","85.1023622047244"
"33140","2023",67,55,12,"82.089552238806","17.910447761194","239470.47761194","2915.0447761194","84.1940298507463"
"33141","2023",7,7,0,100,0,"410442.857142857",3307,"124.285714285714"
"33142","2023",16,16,0,100,0,"252393.4375","2494.1875","101.75"
"33143","2023",24,24,0,100,0,"248668.333333333","2536.25","101.583333333333"
"33144","2023",7,7,0,100,0,"202335.714285714",2147,"96.1428571428571"
"33145","2023",4,4,0,100,0,318745,"2886.5","109.75"
"33146","2023",16,16,0,100,0,"256304.0625","2298.625","114.3125"
"33147","2023",2,2,0,100,0,257500,2116,121
"33148","2023",1,1,0,100,0,141000,1128,125
"33150","2023",2,2,0,100,0,"224262.5","2165.5",103
"33151","2023",6,6,0,100,0,"147666.666666667","1707.5","88.1666666666667"
"33152","2023",1,1,0,100,0,110000,2037,54
"33153","2023",3,3,0,100,0,"380666.666666667","2254.66666666667","162.333333333333"
"33154","2023",27,21,6,"77.7777777777778","22.2222222222222","105103.185185185","1285.92592592593","83.6296296296296"
"33155","2023",2,2,0,100,0,146710,"2088.5",89
"33156","2023",1,1,0,100,0,165000,948,174
"33157","2023",8,8,0,100,0,"269659.375",2404,"120.625"
"33159","2023",25,22,3,88,12,"105868.32","1386.76","76.88"
"33160","2023",3,3,0,100,0,"225533.333333333",2278,"98.3333333333333"
"33161","2023",12,12,0,100,0,"215801.583333333","1561.83333333333","141.666666666667"
"33162","2023",334,157,177,"47.0059880239521","52.9940119760479","291078.083832335","3881.30239520958","74.9071856287425"
"33163","2023",1,1,0,100,0,242000,2719,89
"33164","2023",21,21,0,100,0,"278738.80952381","2553.85714285714","108.857142857143"
"33165","2023",45,24,21,"53.3333333333333","46.6666666666667","285390.755555556","3596.17777777778","82.0222222222222"
"33166","2023",9,9,0,100,0,"164944.444444444","1498.77777777778","105.222222222222"
"33167","2023",163,90,73,"55.2147239263804","44.7852760736196","274360.797546012","3532.53987730061","78.638036809816"
"33168","2023",5,5,0,100,0,95100,"970.6",91
"33170","2023",12,12,0,100,0,"124182.5","1282.41666666667","97.75"
"33172","2023",3,3,0,100,0,135200,1390,"97.3333333333333"
"33173","2023",2,2,0,100,0,171500,"1539.5",112
"33174","2023",8,8,0,100,0,"279741.25","2362.625","120.75"
"33175","2023",6,6,0,100,0,186885,"1654.66666666667","111.833333333333"
"33176","2023",2,2,0,100,0,170500,"1628.5","103.5"
"33177","2023",29,24,5,"82.7586206896552","17.2413793103448","168012.413793103","2424.24137931034","82.9655172413793"
"33178","2023",3,3,0,100,0,"215666.666666667","1510.66666666667","144.333333333333"
"33179","2023",48,41,7,"85.4166666666667","14.5833333333333","200676.041666667","2161.9375","94.375"
"33180","2023",1,1,0,100,0,385170,1167,330
"33181","2023",2,2,0,100,0,"513500.5","5170.5",113
"33182","2023",9,9,0,100,0,225818,"2064.33333333333","110.111111111111"
"33183","2023",10,10,0,100,0,291825,2880,"101.8"
"33184","2023",2,2,0,100,0,287500,1658,203
"33185","2023",20,16,4,80,20,"230439.75","2369.75","98.25"
"33186","2023",16,16,0,100,0,"159768.75","1507.1875",107
"33187","2023",20,12,8,60,40,"123354.5","1661.55","77.6"
"33188","2023",5,5,0,100,0,194200,1664,"126.2"
"33189","2023",6,6,0,100,0,"157893.166666667",1667,"95.5"
"33191","2023",6,6,0,100,0,"280843.666666667","2428.5","149.5"
"33192","2023",297,120,177,"40.4040404040404","59.5959595959596","286313.050505051","3925.54545454545","74.2794612794613"
"33193","2023",26,26,0,100,0,"271717.307692308","3184.46153846154","87.8076923076923"
"33194","2023",10,10,0,100,0,216400,1585,"142.7"
"33195","2023",20,19,1,95,5,"146466.75","1347.2","117.75"
"33197","2023",1,1,0,100,0,210000,1544,136
"33198","2023",25,24,1,96,4,"164744.2","1510.44","118.88"
"33199","2023",331,255,76,"77.0392749244713","22.9607250755287","434532.598187311","5407.39577039275","82.6253776435045"
"33200","2023",149,70,79,"46.9798657718121","53.0201342281879","292028.194630872","3761.68456375839","78.5838926174497"
"33201","2023",6,5,1,"83.3333333333333","16.6666666666667","274333.333333333","2271.33333333333",124
"33202","2023",22,19,3,"86.3636363636364","13.6363636363636","301554.545454545","3339.09090909091","93.2727272727273"
"33203","2023",91,65,26,"71.4285714285714","28.5714285714286","235775.208791209","3858.17582417582","63.6483516483516"
"33204","2023",7,7,0,100,0,"195894.285714286","1586.42857142857","130.428571428571"
"33205","2023",8,8,0,100,0,260451,"2331.375",116
"33206","2023",4,4,0,100,0,247375,"2286.25","147.5"
"33207","2023",45,45,0,100,0,"367947.822222222","3016.66666666667","119.511111111111"
"33208","2023",10,10,0,100,0,"243886.1","2013.6","123.7"
"33209","2023",6,6,0,100,0,"282566.666666667",2342,124
"33210","2023",2,2,0,100,0,168500,1894,"117.5"
"33211","2023",4,4,0,100,0,"228462.5","2643.75","84.5"
"33212","2023",3,3,0,100,0,"284454.666666667",2360,"136.666666666667"
"33213","2023",37,32,5,"86.4864864864865","13.5135135135135","419893.675675676","3679.75675675676","113.72972972973"
"33214","2023",240,137,103,"57.0833333333333","42.9166666666667","333681.191666667","5636.15416666667","58.6458333333333"
"33216","2023",3,3,0,100,0,"246283.333333333","2025.66666666667",118
"33218","2023",13,13,0,100,0,"205387.153846154","1880.15384615385",107
"33219","2023",25,21,4,84,16,"224250.84",2416,"92.4"
"33220","2023",14,14,0,100,0,"212521.642857143","2456.71428571429","87.7142857142857"
"33221","2023",14,13,1,"92.8571428571429","7.14285714285714","126461.928571429","1245.14285714286","102.785714285714"
"33222","2023",5,5,0,100,0,201200,2081,"100.4"
"33223","2023",3,3,0,100,0,"209183.333333333","1408.33333333333","137.666666666667"
"33224","2023",3,3,0,100,0,"261683.333333333","1432.33333333333","156.666666666667"
"33225","2023",29,28,1,"96.551724137931","3.44827586206897","250633.413793103","2234.68965517241","111.51724137931"
"33226","2023",29,28,1,"96.551724137931","3.44827586206897","196939.517241379","2077.79310344828","104.068965517241"
"33227","2023",131,71,60,"54.1984732824427","45.8015267175573","157908.061068702","2143.98473282443","78.8320610687023"
"33228","2023",1,1,0,100,0,130000,1313,99
"33229","2023",119,92,27,"77.3109243697479","22.6890756302521","411056.521008403","5104.65546218487","82.3697478991597"
"33230","2023",5,5,0,100,0,179800,"1916.4","115.6"
"33231","2023",1,1,0,100,0,291350,3004,97
"33233","2023",16,16,0,100,0,"230947.0625","2421.125","100.5"
"33234","2023",28,25,3,"89.2857142857143","10.7142857142857","420479.678571429","3780.32142857143","119.821428571429"
"33235","2023",2,2,0,100,0,642500,"3537.5",169
"33236","2023",146,108,38,"73.972602739726","26.027397260274","896654.116438356","9878.25342465753","93.3082191780822"
"33237","2023",11,11,0,100,0,"210913.636363636","2787.36363636364","101.363636363636"
"33238","2023",101,92,9,"91.0891089108911","8.91089108910891","397338.326732673","3804.43564356436","102.138613861386"
"33239","2023",3,3,0,100,0,"260816.666666667","1657.33333333333",161
"33240","2023",91,66,25,"72.5274725274725","27.4725274725275","162122.681318681","1945.23076923077","83.9010989010989"
"33241","2023",7,7,0,100,0,"165385.714285714","2043.57142857143","88.5714285714286"
"33242","2023",11,11,0,100,0,"156010.909090909","1259.54545454545",140
"33243","2023",382,217,165,"56.8062827225131","43.1937172774869","209811.041884817","2705.63612565445","77.3298429319372"
"33244","2023",1,1,0,100,0,210000,2386,88
"33245","2023",10,10,0,100,0,309860,"2485.1","132.7"
"33246","2023",2,2,0,100,0,95000,1234,"72.5"
"33247","2023",1,1,0,100,0,419000,1822,230
"33248","2023",32,32,0,100,0,"248514.78125","2463.40625","104.34375"
"33249","2023",185,63,122,"34.0540540540541","65.945945945946","200477.810810811","2860.17297297297","70.6486486486486"
"33250","2023",2,2,0,100,0,316925,"2141.5",152
"33251","2023",7,7,0,100,0,"282541.428571429",2624,"110.857142857143"
"33252","2023",8,8,0,100,0,"377701.5",3097,114
"33253","2023",7,7,0,100,0,"179221.428571429","1961.85714285714","95.8571428571429"
"33254","2023",2,2,0,100,0,197175,"1637.5",119
"33255","2023",2,2,0,100,0,182891,1399,128
"33256","2023",60,47,13,"78.3333333333333","21.6666666666667","272398.666666667","3190.61666666667","85.3"
"33257","2023",2,2,0,100,0,210500,"2449.5","85.5"
"33258","2023",2,2,0,100,0,105500,696,150
"33259","2023",11,11,0,100,0,"210387.272727273","2193.63636363636","97.7272727272727"
"33260","2023",6,6,0,100,0,"230333.333333333","1992.16666666667","117.833333333333"
"33261","2023",16,15,1,"93.75","6.25","257069.875","1795.0625","131.5"
"33262","2023",48,44,4,"91.6666666666667","8.33333333333333","272689.895833333","3001.3125","96.0833333333333"
"33264","2023",11,11,0,100,0,"166867.909090909","1687.45454545455",99
"33266","2023",6,6,0,100,0,"307458.333333333","2605.16666666667","119.666666666667"
"33268","2023",29,27,2,"93.1034482758621","6.89655172413793","248712.75862069","2722.96551724138","103.413793103448"
"33269","2023",2,2,0,100,0,417790,"1961.5",198
"33271","2023",4,4,0,100,0,"192452.5",2103,"94.75"
"33272","2023",11,11,0,100,0,"284004.545454545","2408.72727272727","120.545454545455"
"33273","2023",66,51,15,"77.2727272727273","22.7272727272727","379852.515151515","3915.74242424242","98.5151515151515"
"33274","2023",20,18,2,90,10,"432942.5","4038.65","105.2"
"33276","2023",1,1,0,100,0,252180,3192,79
"33277","2023",2,2,0,100,0,268500,2882,"88.5"
"33278","2023",2,2,0,100,0,238100,2055,"117.5"
"33279","2023",8,8,0,100,0,"203256.375",1907,"108.625"
"33280","2023",3,3,0,100,0,189300,"1528.66666666667","130.333333333333"
"33281","2023",1026,340,686,"33.1384015594542","66.8615984405458","289745.012670565","3940.18226120858","73.1267056530214"
"33282","2023",1,1,0,100,0,423000,2712,156
"33283","2023",2,2,0,100,0,"237747.5",1986,108
"33284","2023",93,84,9,"90.3225806451613","9.67741935483871","373976.903225806","4181.65591397849","92.6881720430108"
"33285","2023",7,7,0,100,0,"233367.857142857","2345.85714285714","106.285714285714"
"33287","2023",2,2,0,100,0,173975,1729,105
"33288","2023",1,1,0,100,0,110000,1571,70
"33289","2023",33,31,2,"93.9393939393939","6.06060606060606","175029.03030303","1656.30303030303","99.4848484848485"
"33290","2023",20,19,1,95,5,"404835.7","2667.6","142.5"
"33291","2023",2,2,0,100,0,154500,"1709.5",96
"33293","2023",51,33,18,"64.7058823529412","35.2941176470588","241767.843137255","3117.58823529412","83.6862745098039"
"33294","2023",7,7,0,100,0,"179872.857142857","1503.14285714286","117.571428571429"
"33295","2023",1,1,0,100,0,224173,2637,85
"33296","2023",7,7,0,100,0,"122142.857142857","1367.85714285714","87.5714285714286"
"33297","2023",24,24,0,100,0,"263446.166666667","2554.375","110.375"
"33298","2023",12,9,3,75,25,"239212.25","2379.66666666667","98.5"
"33299","2023",2,2,0,100,0,111250,"1159.5","126.5"
"33300","2023",12,12,0,100,0,"273096.166666667","3095.91666666667","88.0833333333333"
"33301","2023",4,4,0,100,0,200400,1545,"130.25"
"33302","2023",5,5,0,100,0,281900,"2543.8","115.2"
"33303","2023",2,2,0,100,0,162750,1762,"87.5"
"33304","2023",1,1,0,100,0,250500,1869,134
"33305","2023",7,7,0,100,0,"206918.571428571","2133.28571428571","103.142857142857"
"33307","2023",15,15,0,100,0,"220740.333333333","2002.46666666667","114.733333333333"
"33308","2023",1,1,0,100,0,160000,1333,120
"33309","2023",8,8,0,100,0,"177442.75","2048.25","86.375"
"33310","2023",2,2,0,100,0,246500,2021,"126.5"
"33311","2023",18,14,4,"77.7777777777778","22.2222222222222","198285.666666667","2270.61111111111","87.7777777777778"
"33312","2023",108,69,39,"63.8888888888889","36.1111111111111","284001.064814815","3483.48148148148","84.3518518518518"
"33314","2023",49,46,3,"93.8775510204082","6.12244897959184","144663.06122449","1841.89795918367","86.1020408163265"
"33315","2023",21,21,0,100,0,"161394.285714286","1822.66666666667","97.1904761904762"
"33316","2023",8,8,0,100,0,"247421.25","1679.875","152.875"
"33317","2023",11,11,0,100,0,"223873.818181818","2686.27272727273","84.9090909090909"
"33318","2023",612,344,268,"56.2091503267974","43.7908496732026","336074.696078431","4079.54248366013","82.5098039215686"
"33319","2023",9,9,0,100,0,"151717.111111111","1737.44444444444","95.4444444444444"
"33320","2023",7,7,0,100,0,"169142.857142857","1963.85714285714","87.2857142857143"
"33321","2023",18,18,0,100,0,"285601.111111111","2980.16666666667","96.6666666666667"
"33322","2023",45,44,1,"97.7777777777778","2.22222222222222","391855.333333333","3624.91111111111","112.8"
"33323","2023",7,7,0,100,0,235850,"2260.85714285714","104.142857142857"
"33324","2023",97,56,41,"57.7319587628866","42.2680412371134","121732.865979381","1420.0206185567","84.0515463917526"
"33325","2023",13,13,0,100,0,"236530.692307692","1961.61538461538","111.307692307692"
"33326","2023",1,1,0,100,0,295570,1206,245
"33327","2023",21,21,0,100,0,"225052.142857143","2442.80952380952","95.4285714285714"
"33328","2023",6,6,0,100,0,212750,"2035.16666666667","102.5"
"33329","2023",5,5,0,100,0,247700,"1921.6","125.4"
"33330","2023",35,27,8,"77.1428571428572","22.8571428571429","403034.285714286","3537.17142857143","121.8"
"33331","2023",3,3,0,100,0,195500,"1392.66666666667","169.666666666667"
"33332","2023",17,17,0,100,0,156050,"1953.11764705882","85.9411764705882"
"33333","2023",28,28,0,100,0,"383982.5","3997.85714285714","96.75"
"33334","2023",36,33,3,"91.6666666666667","8.33333333333333",230635,"2556.19444444444","94.2222222222222"
"33335","2023",5,5,0,100,0,347943,"3300.2","105.6"
"33336","2023",13,13,0,100,0,"195682.769230769","2000.53846153846","101.461538461538"
"33337","2023",25,25,0,100,0,"204141.16","1900.6","110.88"
"33339","2023",13,13,0,100,0,"255730.769230769","2755.84615384615","97.1538461538462"
"33341","2023",16,16,0,100,0,"182337.625","2033.875","93.75"
"33342","2023",12,12,0,100,0,"227612.333333333","2171.75","105.916666666667"
"33343","2023",16,16,0,100,0,"207412.875","2053.25","100.25"
"33344","2023",5,5,0,100,0,"188620.8","1556.6","125.8"
"33345","2023",6,6,0,100,0,"368371.666666667","2525.16666666667","145.333333333333"
"33346","2023",5,5,0,100,0,"211272.8","2098.8","102.6"
"33347","2023",3,3,0,100,0,"166333.333333333","942.666666666667","181.333333333333"
"33348","2023",16,16,0,100,0,"236479.6875","2115.375","113.3125"
"33349","2023",19,19,0,100,0,"418542.631578947","3538.89473684211","118.210526315789"
"33350","2023",12,12,0,100,0,"243897.5",2151,"116.166666666667"
"33351","2023",19,19,0,100,0,"134892.578947368",1446,"98.7368421052632"
"33352","2023",53,50,3,"94.3396226415094","5.66037735849057","141638.471698113","1497.09433962264","93.6981132075472"
"33353","2023",3,3,0,100,0,166000,1853,"106.666666666667"
"33354","2023",4,4,0,100,0,"312235.25","1362.5","236.25"
"33355","2023",17,17,0,100,0,"152137.058823529","1837.88235294118","84.6470588235294"
"33356","2023",4,4,0,100,0,312050,"2616.5","121.25"
"33357","2023",13,13,0,100,0,310606,"2483.07692307692","125.461538461538"
"33358","2023",11,11,0,100,0,"224375.454545455","1763.72727272727","127.545454545455"
"33359","2023",1,1,0,100,0,475000,3958,120
"33360","2023",2,2,0,100,0,141505,1850,"76.5"
"33361","2023",6,6,0,100,0,"208596.666666667","1797.66666666667","147.166666666667"
"33362","2023",20,20,0,100,0,"201265.65","1843.8","107.95"
"33363","2023",51,51,0,100,0,"356753.843137255","3265.07843137255","110.921568627451"
"33364","2023",5,5,0,100,0,276800,"2151.8","121.6"
"33365","2023",1,1,0,100,0,191820,1918,100
"33366","2023",148,110,38,"74.3243243243243","25.6756756756757",222134,"2664.23648648649","86.0135135135135"
"33367","2023",5,5,0,100,0,237000,2206,"106.8"
"33369","2023",8,8,0,100,0,"241565.625","1629.875","131.375"
"33370","2023",3,3,0,100,0,"106046.666666667","1005.66666666667",110
"33372","2023",1,1,0,100,0,205500,2055,100
"33373","2023",7,7,0,100,0,"140528.571428571","1685.57142857143","78.7142857142857"
"33374","2023",3,3,0,100,0,"181666.666666667","1389.66666666667","138.666666666667"
"33375","2023",4,4,0,100,0,439225,"4187.25",101
"33376","2023",50,47,3,94,6,"504909.52","4215.76","119.82"
"33378","2023",24,24,0,100,0,"175161.5","1733.79166666667","103.416666666667"
"33379","2023",2,2,0,100,0,170000,"1501.5",112
"33380","2023",12,12,0,100,0,"152907.666666667","1569.5","103.083333333333"
"33381","2023",35,28,7,80,20,"285506.885714286","2978.51428571429","96.2"
"33382","2023",24,24,0,100,0,"175651.25","1737.91666666667","105.125"
"33383","2023",7,7,0,100,0,"116264.285714286","1102.71428571429","116.571428571429"
"33384","2023",4,4,0,100,0,671750,"2733.5","192.5"
"33385","2023",6,6,0,100,0,"135966.666666667","1251.5","101.5"
"33387","2023",16,16,0,100,0,"227026.875","1980.0625","112.625"
"33388","2023",5,5,0,100,0,"190363.2","2461.8","81.2"
"33389","2023",34,34,0,100,0,"122525.647058824","1398.76470588235","93.9705882352941"
"33390","2023",2,2,0,100,0,145510,"1525.5",93
"33391","2023",3,2,1,"66.6666666666667","33.3333333333333","210953.333333333",1609,"125.666666666667"
"33392","2023",8,8,0,100,0,"214425.5","2047.875",104
"33393","2023",61,54,7,"88.5245901639344","11.4754098360656","222719.983606557","2094.18032786885","107.377049180328"
"33394","2023",18,17,1,"94.4444444444444","5.55555555555556","525671.777777778","4583.44444444444","101.222222222222"
"33395","2023",19,18,1,"94.7368421052632","5.26315789473684","166079.473684211","1712.31578947368","101.263157894737"
"33396","2023",2,1,1,50,50,139250,"1864.5",80
"33397","2023",38,36,2,"94.7368421052632","5.26315789473684","327655.184210526","3221.5","100.815789473684"
"33398","2023",4,4,0,100,0,302194,"1814.5","153.5"
"33399","2023",2,2,0,100,0,114500,2209,"51.5"
"33400","2023",4,4,0,100,0,"301931.25",2155,"123.5"
"33402","2023",35,25,10,"71.4285714285714","28.5714285714286","96054.9428571429","1174.4","81.8571428571429"
"33403","2023",1,1,0,100,0,260000,1884,138
"33404","2023",2,2,0,100,0,171389,"2362.5","72.5"
"33405","2023",5,5,0,100,0,167310,"1749.6","94.2"
"33406","2023",2,2,0,100,0,240250,2086,120
"33407","2023",7,7,0,100,0,324400,2595,"107.428571428571"
"33408","2023",1,1,0,100,0,230000,2706,85
"33411","2023",1,1,0,100,0,230905,2178,106
"33412","2023",14,14,0,100,0,185755,"1966.64285714286","97.5"
"33413","2023",17,17,0,100,0,"322491.470588235","2634.64705882353",124
"33414","2023",3,3,0,100,0,"220566.666666667",1855,"100.666666666667"
"33415","2023",30,22,8,"73.3333333333333","26.6666666666667","211969.433333333","2521.73333333333","85.8"
"33416","2023",12,12,0,100,0,"206272.916666667","1736.25",119
"33417","2023",20,19,1,95,5,"328917.8","3224.95","101.1"
"33418","2023",5,5,0,100,0,"150809.2","1617.2","95.2"
"33421","2023",7,6,1,"85.7142857142857","14.2857142857143","226584.285714286","1968.71428571429",125
"33422","2023",65,46,19,"70.7692307692308","29.2307692307692","380972.630769231","4047.6","95.9692307692308"
"33423","2023",7,7,0,100,0,149200,1575,91
"33424","2023",54,46,8,"85.1851851851852","14.8148148148148","224790.462962963","2347.38888888889","95.5555555555556"
"33425","2023",12,11,1,"91.6666666666667","8.33333333333333",230776,"2282.66666666667","100.666666666667"
"33426","2023",1,1,0,100,0,80000,1600,50
"33427","2023",2,2,0,100,0,261500,"1673.5",155
"33428","2023",2,2,0,100,0,107250,704,155
"33429","2023",4,4,0,100,0,"254237.5","2516.5",103
"33431","2023",1,1,0,100,0,286160,3367,85
"33433","2023",65,55,10,"84.6153846153846","15.3846153846154","287095.092307692","3102.87692307692","96.8307692307692"
"33434","2023",32,22,10,"68.75","31.25","177782.84375","2514.46875","72.0625"
"33435","2023",39,24,15,"61.5384615384615","38.4615384615385","177300.769230769","1977.97435897436","92.9487179487179"
"33436","2023",10,10,0,100,0,284345,"3213.5","90.9"
"33437","2023",21,21,0,100,0,"189675.238095238",1886,"104.238095238095"
"33438","2023",27,27,0,100,0,"231748.185185185","2301.03703703704","104.481481481481"
"33439","2023",7,6,1,"85.7142857142857","14.2857142857143","172247.857142857","1525.85714285714","117.428571428571"
"33441","2023",25,14,11,56,44,120596,"1661.48","77.2"
"33442","2023",6,6,0,100,0,337365,2391,"122.833333333333"
"33443","2023",1,1,0,100,0,130000,663,196
"33444","2023",4,4,0,100,0,157270,"1154.75",132
"33445","2023",9,9,0,100,0,"198109.111111111","2257.55555555556","92.3333333333333"
"33447","2023",43,42,1,"97.6744186046512","2.32558139534884","134230.465116279","1831.09302325581","85.8372093023256"
"33448","2023",27,27,0,100,0,"349878.111111111","3489.88888888889",102
"33449","2023",278,204,74,"73.3812949640288","26.6187050359712","336860.097122302","3868.14028776978","88.1798561151079"
"33450","2023",7,7,0,100,0,"178005.714285714","1684.71428571429","100.428571428571"
"33451","2023",6,5,1,"83.3333333333333","16.6666666666667","360819.333333333","3724.66666666667","118.666666666667"
"33452","2023",8,8,0,100,0,205131,"2367.75","88.25"
"33453","2023",2,2,0,100,0,269050,1570,174
"33454","2023",10,10,0,100,0,310346,"2868.8","114.3"
"33456","2023",4,4,0,100,0,173950,1223,127
"33457","2023",8,8,0,100,0,"260637.5","1989.375","129.625"
"33458","2023",10,10,0,100,0,241240,"2304.5","105.7"
"33459","2023",3,3,0,100,0,"137333.333333333",1931,"104.666666666667"
"33460","2023",7,7,0,100,0,153380,1767,"86.7142857142857"
"33461","2023",4,4,0,100,0,"185101.25","1912.25",99
"33462","2023",5,5,0,100,0,209256,2080,"109.2"
"33463","2023",17,17,0,100,0,"194277.058823529","2017.64705882353","98.1764705882353"
"33464","2023",2,2,0,100,0,209500,"1784.5","126.5"
"33465","2023",8,8,0,100,0,"242452.5","2109.5","117.5"
"33466","2023",52,12,40,"23.0769230769231","76.9230769230769","130716.403846154","2436.61538461538","52.1538461538462"
"33467","2023",3,3,0,100,0,"205316.666666667","1764.33333333333","112.333333333333"
"33468","2023",11,11,0,100,0,"151709.090909091","1426.36363636364","91.9090909090909"
"33470","2023",10,10,0,100,0,317865,"2470.4",133
"33471","2023",8,8,0,100,0,"185556.25","2421.5",83
"33472","2023",1,1,0,100,0,187500,1752,107
"33473","2023",32,32,0,100,0,"193853.5625","1876.90625","101.875"
"33474","2023",29,29,0,100,0,"384027.965517241","3274.86206896552","118.896551724138"
"33475","2023",6,6,0,100,0,221125,"2104.66666666667","105.5"
"33476","2023",5,5,0,100,0,135000,"1505.4","93.6"
"33477","2023",18,17,1,"94.4444444444444","5.55555555555556","149619.722222222","1442.5","110.722222222222"
"33478","2023",61,42,19,"68.8524590163934","31.1475409836066","152909.524590164","1750.4262295082","82.7540983606557"
"33479","2023",3,3,0,100,0,300000,2110,157
"33480","2023",12,12,0,100,0,194500,"1943.66666666667","99.1666666666667"
"33481","2023",2,2,0,100,0,291250,"1692.5",171
"33482","2023",3,3,0,100,0,"155666.666666667","2460.66666666667",68
"33483","2023",33,30,3,"90.9090909090909","9.09090909090909","327582.878787879","3032.15151515152","109.909090909091"
"33484","2023",23,22,1,"95.6521739130435","4.34782608695652","228455.304347826","2090.86956521739","122.869565217391"
"33485","2023",21,21,0,100,0,"299787.285714286","2364.33333333333","128.142857142857"
"33486","2023",5,5,0,100,0,191800,"2350.6","82.8"
"33487","2023",6,6,0,100,0,"309592.5","3100.66666666667","101.833333333333"
"33488","2023",1,1,0,100,0,97000,874,111
"33489","2023",1,1,0,100,0,357562,2980,120
"33490","2023",29,25,4,"86.2068965517241","13.7931034482759","200691.862068966","2326.1724137931","89.448275862069"
"33491","2023",4,4,0,100,0,"286240.5","2336.75","127.25"
"33492","2023",35,24,11,"68.5714285714286","31.4285714285714","147778.2","2032.88571428571","75.3714285714286"
"33493","2023",5,5,0,100,0,279008,1277,"191.4"
"33494","2023",3,3,0,100,0,"524966.666666667",4349,"121.666666666667"
"33496","2023",28,27,1,"96.4285714285714","3.57142857142857","321780.071428571","2883.82142857143","112.571428571429"
"33498","2023",71,64,7,"90.1408450704225","9.85915492957746",377541,"3702.97183098592","105.183098591549"
"33499","2023",5,5,0,100,0,173800,"1721.8","109.2"
"33500","2023",7,7,0,100,0,174200,"1660.28571428571","106.714285714286"
"33501","2023",33,31,2,"93.9393939393939","6.06060606060606","346233.03030303","3702.33333333333",96
"33502","2023",5,5,0,100,0,164814,"1590.4","112.8"
"33503","2023",4,4,0,100,0,"325977.5",3633,"93.5"
"33504","2023",6,6,0,100,0,"293523.333333333","2266.83333333333","133.833333333333"
"33505","2023",11,11,0,100,0,"248133.272727273","2429.63636363636","103.818181818182"
"33506","2023",16,14,2,"87.5","12.5","209218.125","2045.375","96.9375"
"33507","2023",5,5,0,100,0,261622,"1977.4","121.4"
"33508","2023",5,5,0,100,0,225194,"2087.8",105
"33509","2023",4,4,0,100,0,236905,2000,"123.25"
"33510","2023",2,2,0,100,0,213000,2320,90
"33511","2023",4,4,0,100,0,"129412.5",1465,"89.75"
"33512","2023",6,6,0,100,0,198350,"2487.66666666667","84.5"
"33514","2023",120,79,41,"65.8333333333333","34.1666666666667","268345.358333333","4245.88333333333","67.7916666666667"
"33515","2023",3,3,0,100,0,185000,1914,"101.333333333333"
"33516","2023",1,1,0,100,0,168400,1736,97
"33517","2023",17,17,0,100,0,"266870.705882353","2663.41176470588","103.647058823529"
"33518","2023",12,12,0,100,0,"229525.666666667","2494.58333333333","102.916666666667"
"33519","2023",103,95,8,"92.2330097087379","7.76699029126214","413640.291262136","3957.02912621359","105.679611650485"
"33520","2023",4,4,0,100,0,"156947.5","1474.75","121.25"
"33521","2023",13,13,0,100,0,"232777.461538462","2114.07692307692","102.692307692308"
"33522","2023",594,210,384,"35.3535353535354","64.6464646464647","286958.496632997","4448.13131313131","65.5942760942761"
"33523","2023",27,24,3,"88.8888888888889","11.1111111111111","246405.481481481","2540.22222222222","97.0740740740741"
"33524","2023",3,3,0,100,0,"266166.666666667","2079.33333333333","127.666666666667"
"33525","2023",8,8,0,100,0,"163343.75","2155.5","79.75"
"33527","2023",113,73,40,"64.6017699115044","35.3982300884956","362680.008849558","4434.00884955752","80.9734513274336"
"33528","2023",2,2,0,100,0,307000,3973,81
"33529","2023",429,283,146,"65.967365967366","34.032634032634","545677.668997669","5904.64335664336","86.6969696969697"
"33530","2023",11,11,0,100,0,255880,2072,"128.636363636364"
"33531","2023",2,2,0,100,0,258750,"2613.5",99
"33532","2023",11,11,0,100,0,"233428.272727273","1849.09090909091","125.181818181818"
"33533","2023",34,31,3,"91.1764705882353","8.82352941176471","218970.294117647","2334.85294117647",95
"33534","2023",6,6,0,100,0,"245316.666666667",2651,91
"33535","2023",41,39,2,"95.1219512195122","4.8780487804878","375638.682926829","3288.17073170732","115.731707317073"
"33536","2023",3,3,0,100,0,168900,"2776.33333333333",81
"33537","2023",5,5,0,100,0,190628,"1915.2","112.6"
"33538","2023",9,9,0,100,0,"117772.222222222","1276.33333333333","93.1111111111111"
"33539","2023",44,38,6,"86.3636363636364","13.6363636363636","232547.772727273","2291.36363636364","106.477272727273"
"33540","2023",65,63,2,"96.9230769230769","3.07692307692308","280897.861538462","3735.2","84.0923076923077"
"33541","2023",19,19,0,100,0,"239698.526315789","2510.57894736842","91.4210526315789"
"33542","2023",10,10,0,100,0,178695,"1814.8",100
"33543","2023",10,9,1,90,10,"192021.5",1841,"114.6"
"33544","2023",56,21,35,"37.5","62.5","148611.803571429","2604.25","60.4821428571429"
"33545","2023",21,21,0,100,0,"205595.80952381","1978.28571428571","108.428571428571"
"33546","2023",3,3,0,100,0,"158133.333333333","1367.66666666667",116
"33547","2023",14,14,0,100,0,"185207.142857143","2159.92857142857","89.7857142857143"
"33548","2023",14,14,0,100,0,"200358.357142857","2029.57142857143","94.7857142857143"
"33549","2023",4,3,1,75,25,146750,1564,96
"33550","2023",465,278,187,"59.7849462365591","40.2150537634409","284123.965591398","3674.43870967742","78.6236559139785"
"33551","2023",2,2,0,100,0,147000,1546,87
"33552","2023",11,11,0,100,0,"244827.181818182","2336.36363636364","102.181818181818"
"33553","2023",10,10,0,100,0,216005,"2244.2","98.6"
"33554","2023",27,26,1,"96.2962962962963","3.7037037037037","295807.555555556","3253.96296296296","94.1851851851852"
"33555","2023",42,31,11,"73.8095238095238","26.1904761904762",306498,"3548.80952380952","86.9047619047619"
"33001","2024",20,20,0,0,100,121125,1432,91
"33002","2024",6,6,0,0,100,250295,2014,105
"33003","2024",148,116,32,22,78,236091,2767,89
"33004","2024",33,14,19,58,42,147548,1982,75
"33005","2024",203,151,52,26,74,451380,5451,86
"33006","2024",9,9,0,0,100,178102,1441,121
"33007","2024",11,11,0,0,100,252771,2692,96
"33008","2024",2,2,0,0,100,109000,1190,92
"33009","2024",389,105,284,73,27,525822,8300,62
"33010","2024",11,11,0,0,100,237055,2674,88
"33011","2024",121,94,27,22,78,373074,5229,76
"33012","2024",35,35,0,0,100,331984,3318,103
"33013","2024",70,41,29,41,59,270023,3116,87
"33014","2024",6,6,0,0,100,254925,2250,105
"33015","2024",14,14,0,0,100,224494,2578,101
"33017","2024",4,4,0,0,100,265812,1762,156
"33018","2024",31,30,1,3,97,242032,2262,109
"33019","2024",118,68,50,42,58,308688,3979,77
"33021","2024",10,10,0,0,100,168156,1705,104
"33022","2024",26,24,2,8,92,236817,2525,97
"33023","2024",7,7,0,0,100,318421,2992,106
"33024","2024",1,1,0,0,100,268000,2851,94
"33025","2024",4,4,0,0,100,183498,1825,94
"33026","2024",4,4,0,0,100,141250,1679,119
"33027","2024",2,2,0,0,100,187925,1038,190
"33028","2024",3,3,0,0,100,128333,1310,96
"33029","2024",38,30,8,21,79,294868,3286,91
"33030","2024",30,27,3,10,90,199947,2101,96
"33032","2024",60,33,27,45,55,215639,2984,73
"33033","2024",6,6,0,0,100,333958,2662,116
"33034","2024",7,7,0,0,100,248657,2006,126
"33035","2024",4,4,0,0,100,204838,1644,120
"33036","2024",43,37,6,14,86,182598,1970,100
"33037","2024",20,19,1,5,95,249550,2469,107
"33038","2024",15,15,0,0,100,204556,1238,159
"33039","2024",357,163,194,54,46,276071,3696,75
"33040","2024",13,12,1,8,92,165850,1850,100
"33042","2024",64,62,2,3,97,272219,2832,98
"33043","2024",3,3,0,0,100,329803,2827,113
"33044","2024",2,2,0,0,100,257500,3778,66
"33045","2024",3,3,0,0,100,107556,1360,81
"33046","2024",12,12,0,0,100,207849,1845,114
"33047","2024",19,19,0,0,100,207124,1846,112
"33048","2024",1,1,0,0,100,408000,3290,124
"33049","2024",22,22,0,0,100,320239,2746,122
"33050","2024",5,5,0,0,100,196677,1712,117
"33051","2024",99,76,23,23,77,284088,3635,80
"33052","2024",5,5,0,0,100,194340,1788,112
"33054","2024",2,2,0,0,100,253800,2226,114
"33055","2024",3,3,0,0,100,137096,1241,109
"33056","2024",112,84,28,25,75,326601,3329,99
"33057","2024",5,5,0,0,100,118743,1062,107
"33058","2024",62,37,25,40,60,126417,1668,76
"33060","2024",4,4,0,0,100,90700,904,90
"33061","2024",7,7,0,0,100,422756,3926,109
"33062","2024",4,4,0,0,100,193250,1988,95
"33063","2024",3747,875,2872,77,23,312153,4549,69
"33065","2024",29,24,5,17,83,540582,4200,122
"33067","2024",31,30,1,3,97,163092,1532,106
"33068","2024",1,1,0,0,100,276300,2017,137
"33069","2024",322,149,173,54,46,400851,4496,86
"33070","2024",4,4,0,0,100,329187,3272,102
"33071","2024",16,16,0,0,100,208866,2048,112
"33072","2024",1,1,0,0,100,81665,698,117
"33073","2024",11,11,0,0,100,143038,1639,90
"33075","2024",258,96,162,63,37,291564,3747,76
"33076","2024",10,10,0,0,100,205135,1735,128
"33077","2024",18,18,0,0,100,282656,2543,116
"33078","2024",3,3,0,0,100,302545,2415,127
"33079","2024",2,2,0,0,100,140500,1569,90
"33080","2024",58,42,16,28,72,272060,3423,80
"33081","2024",28,20,8,29,71,162314,2153,74
"33082","2024",10,10,0,0,100,178850,1965,93
"33083","2024",8,8,0,0,100,357932,2749,126
"33084","2024",19,16,3,16,84,264806,3081,85
"33085","2024",23,22,1,4,96,363376,3579,102
"33086","2024",2,2,0,0,100,132750,1616,84
"33087","2024",8,8,0,0,100,186500,1604,122
"33088","2024",9,9,0,0,100,172214,1941,91
"33089","2024",2,2,0,0,100,125925,1376,100
"33090","2024",28,24,4,14,86,327434,3524,95
"33093","2024",6,6,0,0,100,215617,2162,101
"33094","2024",1,1,0,0,100,45000,900,50
"33095","2024",10,10,0,0,100,139831,1442,101
"33096","2024",60,44,16,27,73,244944,2813,88
"33097","2024",67,41,26,39,61,247929,3965,66
"33098","2024",2,2,0,0,100,285850,2606,110
"33099","2024",25,25,0,0,100,343702,3335,110
"33100","2024",10,10,0,0,100,202265,2032,104
"33101","2024",11,10,1,9,91,192073,2127,102
"33102","2024",3,3,0,0,100,61031,1226,60
"33104","2024",61,55,6,10,90,229568,2648,89
"33105","2024",2,2,0,0,100,394298,2520,148
"33106","2024",11,10,1,9,91,186433,2056,93
"33108","2024",43,34,9,21,79,151403,1544,100
"33109","2024",21,21,0,0,100,241102,2677,92
"33111","2024",13,12,1,8,92,167603,1633,113
"33112","2024",3,3,0,0,100,283400,1488,176
"33113","2024",3,3,0,0,100,133333,1784,77
"33114","2024",28,14,14,50,50,130487,1946,70
"33115","2024",2,2,0,0,100,205000,1762,122
"33116","2024",2,2,0,0,100,203250,2799,72
"33117","2024",4,4,0,0,100,141900,1388,126
"33118","2024",27,27,0,0,100,341820,3257,104
"33119","2024",257,87,170,66,34,201671,3126,65
"33120","2024",17,16,1,6,94,271272,2490,117
"33121","2024",1,1,0,0,100,245000,2207,111
"33122","2024",114,110,4,4,96,390109,3602,111
"33123","2024",21,21,0,0,100,224203,2217,102
"33124","2024",9,9,0,0,100,206874,1689,118
"33125","2024",23,23,0,0,100,275443,2292,118
"33126","2024",8,8,0,0,100,243404,2742,101
"33127","2024",1,1,0,0,100,147000,860,171
"33128","2024",6,6,0,0,100,202467,1808,106
"33129","2024",1,1,0,0,100,166000,1886,88
"33130","2024",9,9,0,0,100,217032,1840,132
"33131","2024",1,1,0,0,100,1084321,5768,188
"33132","2024",3,3,0,0,100,286567,1862,147
"33134","2024",1,1,0,0,100,147000,1515,97
"33135","2024",2,2,0,0,100,283660,2208,136
"33136","2024",2,2,0,0,100,537994,2550,200
"33137","2024",7,7,0,0,100,158600,1463,111
"33138","2024",100,85,15,15,85,156252,1817,94
"33139","2024",2,2,0,0,100,161200,1418,108
"33140","2024",53,39,14,26,74,203778,2737,75
"33141","2024",7,7,0,0,100,376771,3078,120
"33142","2024",17,17,0,0,100,229388,2622,96
"33143","2024",28,26,2,7,93,244338,2248,109
"33144","2024",5,5,0,0,100,152003,1854,82
"33145","2024",8,8,0,0,100,378698,2847,129
"33146","2024",20,20,0,0,100,216534,2204,104
"33147","2024",3,3,0,0,100,185000,2011,94
"33148","2024",1,1,0,0,100,200000,1000,200
"33149","2024",1,1,0,0,100,686350,2288,300
"33150","2024",2,2,0,0,100,215035,1023,210
"33151","2024",10,10,0,0,100,116394,1263,91
"33152","2024",1,1,0,0,100,216601,3185,68
"33153","2024",3,3,0,0,100,187580,2319,112
"33154","2024",21,19,2,10,90,96733,1264,77
"33157","2024",4,4,0,0,100,214015,1724,114
"33158","2024",1,1,0,0,100,134000,1072,125
"33159","2024",30,27,3,10,90,108212,1341,81
"33160","2024",4,4,0,0,100,198000,1668,105
"33161","2024",10,10,0,0,100,169628,2095,102
"33162","2024",314,127,187,60,40,247073,3524,71
"33163","2024",2,2,0,0,100,217000,1598,125
"33164","2024",15,15,0,0,100,223826,2016,112
"33165","2024",41,23,18,44,56,269813,3213,83
"33166","2024",5,5,0,0,100,98000,1456,73
"33167","2024",146,82,64,44,56,255110,3337,77
"33168","2024",6,6,0,0,100,250768,1755,132
"33169","2024",1,1,0,0,100,119900,1499,80
"33170","2024",12,12,0,0,100,187335,1441,128
"33171","2024",2,2,0,0,100,96000,1187,80
"33172","2024",3,3,0,0,100,159100,1049,153
"33173","2024",2,2,0,0,100,302036,3414,108
"33174","2024",13,12,1,8,92,270123,2190,127
"33175","2024",2,2,0,0,100,153500,2082,74
"33176","2024",1,1,0,0,100,95000,2375,40
"33177","2024",35,31,4,11,89,224060,2515,100
"33178","2024",4,4,0,0,100,210560,1914,110
"33179","2024",35,27,8,23,77,203069,2300,88
"33181","2024",1,1,0,0,100,250000,3125,80
"33182","2024",16,16,0,0,100,258239,2105,119
"33183","2024",12,12,0,0,100,210094,2357,90
"33184","2024",7,7,0,0,100,91339,1236,79
"33185","2024",16,11,5,31,69,197551,2267,96
"33186","2024",9,9,0,0,100,146167,1186,125
"33187","2024",13,9,4,31,69,170037,1611,114
"33188","2024",1,1,0,0,100,220000,1913,115
"33189","2024",4,3,1,25,75,178100,1452,133
"33190","2024",5,5,0,0,100,103720,1406,78
"33191","2024",7,7,0,0,100,207557,2125,92
"33192","2024",286,109,177,62,38,269909,3736,73
"33193","2024",19,19,0,0,100,243444,2719,91
"33194","2024",5,5,0,0,100,178000,2046,86
"33195","2024",13,13,0,0,100,133613,1259,114
"33196","2024",1,1,0,0,100,275000,1447,190
"33197","2024",4,4,0,0,100,245253,2023,126
"33198","2024",18,18,0,0,100,148846,1915,81
"33199","2024",257,204,53,21,79,398982,4675,87
"33200","2024",152,78,74,49,51,289157,3602,79
"33201","2024",5,5,0,0,100,138555,1800,98
"33202","2024",12,11,1,8,92,263819,2715,101
"33203","2024",97,72,25,26,74,241294,3677,70
"33204","2024",4,4,0,0,100,169796,1449,124
"33205","2024",6,6,0,0,100,275105,1916,135
"33206","2024",9,9,0,0,100,179350,2179,91
"33207","2024",53,53,0,0,100,272038,2654,106
"33208","2024",13,13,0,0,100,149869,2137,83
"33209","2024",1,1,0,0,100,120000,1034,116
"33210","2024",2,2,0,0,100,135000,1899,84
"33211","2024",4,4,0,0,100,325650,3087,128
"33212","2024",2,2,0,0,100,93250,1270,74
"33213","2024",36,25,11,31,69,351107,3164,103
"33214","2024",216,138,78,36,64,321007,5518,59
"33215","2024",2,2,0,0,100,173500,969,209
"33216","2024",1,1,0,0,100,75000,893,84
"33218","2024",11,11,0,0,100,141295,1379,104
"33219","2024",17,15,2,12,88,252915,2407,111
"33220","2024",18,17,1,6,94,184335,2214,93
"33221","2024",9,9,0,0,100,179888,1822,103
"33222","2024",3,3,0,0,100,178733,1989,87
"33223","2024",4,4,0,0,100,119936,1403,88
"33225","2024",22,20,2,9,91,239674,2303,108
"33226","2024",28,24,4,14,86,201077,2170,98
"33227","2024",84,48,36,43,57,146020,2098,74
"33228","2024",9,9,0,0,100,209533,1845,115
"33229","2024",87,66,21,24,76,356607,4554,81
"33230","2024",9,9,0,0,100,205390,1835,115
"33232","2024",1,1,0,0,100,150000,1786,84
"33233","2024",21,18,3,14,86,187591,1900,98
"33234","2024",29,26,3,10,90,461401,3784,119
"33235","2024",3,3,0,0,100,165667,1284,140
"33236","2024",124,95,29,23,77,977025,10071,95
"33237","2024",6,6,0,0,100,243735,1840,140
"33238","2024",68,66,2,3,97,344866,3494,99
"33239","2024",4,4,0,0,100,174500,1990,84
"33240","2024",79,69,10,13,87,163800,1920,88
"33241","2024",9,9,0,0,100,226520,2095,115
"33242","2024",3,3,0,0,100,200000,1528,128
"33243","2024",309,197,112,36,64,193669,2529,79
"33244","2024",3,3,0,0,100,209667,2188,95
"33245","2024",3,3,0,0,100,456050,2868,147
"33246","2024",2,2,0,0,100,118540,1206,114
"33248","2024",15,13,2,13,87,229629,2368,97
"33249","2024",186,68,118,63,37,174402,2619,68
"33250","2024",2,2,0,0,100,150000,1463,114
"33251","2024",2,2,0,0,100,246475,2325,106
"33252","2024",1,1,0,0,100,105000,929,113
"33253","2024",8,7,1,12,88,326977,2365,127
"33254","2024",6,6,0,0,100,213833,1576,137
"33255","2024",1,1,0,0,100,220000,1222,180
"33256","2024",48,41,7,15,85,266612,2806,96
"33257","2024",4,4,0,0,100,274075,2502,110
"33258","2024",3,3,0,0,100,191517,1788,144
"33259","2024",18,17,1,6,94,200472,2087,98
"33260","2024",7,7,0,0,100,481706,5284,121
"33261","2024",8,8,0,0,100,176105,1469,118
"33262","2024",32,30,2,6,94,260216,2566,102
"33263","2024",3,3,0,0,100,298000,3541,86
"33264","2024",6,6,0,0,100,165908,1756,95
"33266","2024",3,2,1,33,67,204400,3170,75
"33268","2024",29,29,0,0,100,212532,2291,103
"33269","2024",5,5,0,0,100,187265,1787,98
"33270","2024",2,2,0,0,100,189500,2034,97
"33271","2024",2,2,0,0,100,229750,2106,110
"33272","2024",8,8,0,0,100,240888,2068,116
"33273","2024",63,42,21,33,67,325723,3703,90
"33274","2024",28,26,2,7,93,391990,3402,115
"33275","2024",2,2,0,0,100,277450,2274,122
"33276","2024",2,2,0,0,100,267100,1682,141
"33279","2024",7,7,0,0,100,212707,1971,119
"33280","2024",5,5,0,0,100,207596,1539,138
"33281","2024",883,310,573,65,35,275169,3695,75
"33282","2024",3,3,0,0,100,150000,2187,79
"33283","2024",3,3,0,0,100,186000,1464,138
"33284","2024",91,82,9,10,90,356023,3751,96
"33285","2024",5,5,0,0,100,172328,1730,104
"33287","2024",2,2,0,0,100,205450,1596,112
"33288","2024",4,4,0,0,100,227000,2088,112
"33289","2024",21,19,2,10,90,198765,2034,107
"33290","2024",10,9,1,10,90,274744,1856,155
"33293","2024",29,23,6,21,79,302301,2820,103
"33294","2024",3,3,0,0,100,206433,1843,117
"33296","2024",14,14,0,0,100,153711,1652,92
"33297","2024",17,17,0,0,100,255348,2493,106
"33298","2024",13,13,0,0,100,327014,3005,94
"33299","2024",1,1,0,0,100,211000,1918,110
"33300","2024",10,10,0,0,100,224682,2660,82
"33301","2024",2,2,0,0,100,130000,1038,144
"33302","2024",2,2,0,0,100,240500,2748,88
"33303","2024",7,7,0,0,100,278671,2179,112
"33304","2024",1,1,0,0,100,390000,2600,150
"33305","2024",5,5,0,0,100,226600,2183,93
"33306","2024",5,5,0,0,100,230085,1853,146
"33307","2024",16,16,0,0,100,202134,1907,107
"33308","2024",2,2,0,0,100,96400,845,134
"33309","2024",4,4,0,0,100,198488,1566,118
"33310","2024",1,1,0,0,100,255000,2073,123
"33311","2024",12,8,4,33,67,172001,2224,78
"33312","2024",104,80,24,23,77,281724,3121,92
"33314","2024",56,49,7,12,88,161907,2016,87
"33315","2024",14,14,0,0,100,139317,1418,105
"33316","2024",11,11,0,0,100,173701,1427,126
"33317","2024",7,7,0,0,100,277332,3205,107
"33318","2024",588,333,255,43,57,307278,3840,81
"33319","2024",6,6,0,0,100,184377,1796,96
"33320","2024",8,8,0,0,100,229125,2643,98
"33321","2024",18,18,0,0,100,241374,2228,108
"33322","2024",45,44,1,2,98,383464,3356,116
"33323","2024",1,1,0,0,100,362000,1326,273
"33324","2024",76,43,33,43,57,115021,1455,77
"33325","2024",7,7,0,0,100,207586,2026,102
"33326","2024",1,1,0,0,100,143000,2383,60
"33327","2024",24,23,1,4,96,211142,2333,92
"33328","2024",5,5,0,0,100,155640,1567,102
"33329","2024",1,1,0,0,100,199500,1995,100
"33330","2024",40,38,2,5,95,349943,3200,110
"33331","2024",3,3,0,0,100,149127,2000,73
"33332","2024",10,10,0,0,100,188240,1618,111
"33333","2024",23,22,1,4,96,401372,4408,92
"33334","2024",24,22,2,8,92,217862,2410,101
"33335","2024",4,4,0,0,100,296638,2860,106
"33336","2024",16,15,1,6,94,135355,1429,98
"33337","2024",33,31,2,6,94,170148,1576,115
"33339","2024",15,14,1,7,93,223997,2520,89
"33341","2024",12,12,0,0,100,244298,2059,122
"33342","2024",9,9,0,0,100,163778,1453,111
"33343","2024",7,7,0,0,100,198001,1944,103
"33344","2024",5,5,0,0,100,150700,1500,108
"33345","2024",2,2,0,0,100,352965,1932,181
"33346","2024",3,3,0,0,100,108667,1671,72
"33347","2024",2,2,0,0,100,137500,1018,124
"33348","2024",10,10,0,0,100,164083,1799,94
"33349","2024",12,12,0,0,100,485927,3391,137
"33350","2024",19,18,1,5,95,171134,1898,94
"33351","2024",12,12,0,0,100,130471,1369,103
"33352","2024",41,38,3,7,93,133732,1392,101
"33353","2024",1,1,0,0,100,270000,2015,134
"33354","2024",1,1,0,0,100,398360,2371,168
"33355","2024",12,12,0,0,100,246065,2385,97
"33356","2024",1,1,0,0,100,140500,1405,100
"33357","2024",17,17,0,0,100,276973,2520,108
"33358","2024",3,3,0,0,100,193133,1873,105
"33360","2024",4,4,0,0,100,147375,1288,113
"33361","2024",3,3,0,0,100,158333,2338,69
"33362","2024",10,10,0,0,100,159800,2187,76
"33363","2024",33,31,2,6,94,300233,3125,96
"33364","2024",4,4,0,0,100,220700,1694,134
"33366","2024",122,85,37,30,70,215543,2622,84
"33367","2024",4,4,0,0,100,191575,2105,92
"33369","2024",3,3,0,0,100,272753,1939,136
"33370","2024",2,2,0,0,100,138100,1345,104
"33372","2024",2,2,0,0,100,110000,788,141
"33373","2024",8,8,0,0,100,154338,1606,99
"33374","2024",9,9,0,0,100,180708,1395,133
"33375","2024",2,2,0,0,100,339185,3097,107
"33376","2024",42,38,4,10,90,473721,3883,125
"33377","2024",1,1,0,0,100,222653,1855,120
"33378","2024",10,10,0,0,100,128972,1388,92
"33379","2024",1,1,0,0,100,450000,4412,102
"33380","2024",24,24,0,0,100,129238,1297,105
"33381","2024",28,27,1,4,96,291382,3106,98
"33382","2024",8,8,0,0,100,202938,1584,138
"33383","2024",4,4,0,0,100,149750,1306,103
"33384","2024",4,4,0,0,100,306125,2864,103
"33385","2024",5,5,0,0,100,223960,2440,102
"33386","2024",2,2,0,0,100,254390,2144,116
"33387","2024",16,16,0,0,100,171069,1753,103
"33388","2024",4,4,0,0,100,236390,2013,114
"33389","2024",29,28,1,3,97,159942,1700,105
"33390","2024",3,3,0,0,100,233185,2337,100
"33391","2024",3,3,0,0,100,133667,1577,90
"33392","2024",7,7,0,0,100,226829,1870,125
"33393","2024",43,40,3,7,93,189353,2092,103
"33394","2024",11,11,0,0,100,493864,3065,145
"33395","2024",14,14,0,0,100,140932,1677,82
"33396","2024",2,2,0,0,100,342020,3504,84
"33397","2024",19,17,2,11,89,309406,3002,104
"33399","2024",1,1,0,0,100,754950,4339,174
"33400","2024",4,4,0,0,100,299730,1767,164
"33401","2024",2,2,0,0,100,247350,1798,133
"33402","2024",37,21,16,43,57,82804,1089,75
"33404","2024",1,1,0,0,100,140000,693,202
"33405","2024",5,5,0,0,100,131600,1195,112
"33406","2024",5,5,0,0,100,195800,1922,88
"33407","2024",8,8,0,0,100,264291,2592,106
"33408","2024",1,1,0,0,100,331100,2365,140
"33411","2024",1,1,0,0,100,126000,1312,96
"33412","2024",10,10,0,0,100,187608,2009,94
"33413","2024",14,14,0,0,100,276583,2472,112
"33414","2024",3,3,0,0,100,221667,2103,114
"33415","2024",26,18,8,31,69,216569,2514,84
"33416","2024",8,8,0,0,100,190138,1857,100
"33417","2024",25,23,2,8,92,291683,2991,99
"33418","2024",6,6,0,0,100,283608,1970,155
"33421","2024",2,1,1,50,50,463235,1866,208
"33422","2024",95,55,40,42,58,314884,3621,88
"33423","2024",4,3,1,25,75,160625,1975,78
"33424","2024",59,50,9,15,85,191667,2154,92
"33425","2024",13,11,2,15,85,255767,2687,104
"33426","2024",3,3,0,0,100,405333,3376,98
"33427","2024",1,1,0,0,100,93000,795,117
"33428","2024",2,2,0,0,100,147000,1726,88
"33429","2024",4,4,0,0,100,110500,1419,98
"33431","2024",1,1,0,0,100,321775,2873,112
"33432","2024",1,1,0,0,100,244650,2522,97
"33433","2024",62,56,6,10,90,253069,2790,94
"33434","2024",22,14,8,36,64,163295,2435,70
"33435","2024",26,17,9,35,65,174705,1961,94
"33436","2024",8,8,0,0,100,266987,2251,126
"33437","2024",30,30,0,0,100,215917,2301,99
"33438","2024",20,20,0,0,100,248445,2393,104
"33439","2024",17,17,0,0,100,201162,2048,98
"33441","2024",22,12,10,45,55,139750,1850,77
"33442","2024",6,6,0,0,100,92183,1377,72
"33443","2024",2,2,0,0,100,204151,1933,125
"33444","2024",1,1,0,0,100,139000,1241,112
"33445","2024",4,4,0,0,100,224175,1732,124
"33447","2024",19,19,0,0,100,138205,1581,90
"33448","2024",22,20,2,9,91,299616,3537,89
"33449","2024",283,213,70,25,75,342995,3647,96
"33450","2024",2,2,0,0,100,117476,1016,128
"33451","2024",7,7,0,0,100,237910,2801,116
"33452","2024",5,5,0,0,100,294220,2855,100
"33453","2024",1,1,0,0,100,90000,804,112
"33454","2024",11,11,0,0,100,420462,3773,117
"33456","2024",6,6,0,0,100,160408,1311,124
"33457","2024",1,1,0,0,100,405000,3092,131
"33458","2024",8,8,0,0,100,160062,1568,110
"33459","2024",1,1,0,0,100,334000,2369,141
"33460","2024",4,4,0,0,100,156912,1980,82
"33461","2024",3,3,0,0,100,458550,2190,193
"33462","2024",4,4,0,0,100,249500,1969,126
"33463","2024",16,16,0,0,100,155618,1763,88
"33464","2024",2,2,0,0,100,182500,1494,121
"33465","2024",9,9,0,0,100,233811,2489,93
"33466","2024",54,17,37,69,31,134551,2448,56
"33467","2024",2,2,0,0,100,382800,3218,118
"33468","2024",2,2,0,0,100,380500,2374,149
"33470","2024",3,3,0,0,100,196333,2037,101
"33471","2024",6,6,0,0,100,197787,1819,108
"33472","2024",2,2,0,0,100,202952,2182,95
"33473","2024",36,31,5,14,86,172743,2069,88
"33474","2024",37,37,0,0,100,338511,2992,115
"33476","2024",12,12,0,0,100,156796,1574,112
"33477","2024",14,10,4,29,71,136299,1619,84
"33478","2024",58,43,15,26,74,116813,1586,72
"33480","2024",8,8,0,0,100,211762,2818,82
"33481","2024",2,2,0,0,100,169750,1970,86
"33482","2024",2,2,0,0,100,207500,1011,206
"33483","2024",36,36,0,0,100,379934,2870,129
"33484","2024",17,17,0,0,100,205919,2383,88
"33485","2024",21,21,0,0,100,247297,2297,108
"33486","2024",2,2,0,0,100,173500,1656,101
"33487","2024",4,4,0,0,100,289750,2463,111
"33488","2024",1,1,0,0,100,178660,1985,90
"33489","2024",5,5,0,0,100,256402,2100,122
"33490","2024",24,22,2,8,92,203086,2282,90
"33491","2024",3,3,0,0,100,301217,1792,167
"33492","2024",27,23,4,15,85,167279,1747,98
"33493","2024",7,7,0,0,100,105557,1058,107
"33494","2024",9,9,0,0,100,403003,3290,123
"33496","2024",15,14,1,7,93,296293,2982,100
"33498","2024",76,73,3,4,96,328215,3299,104
"33499","2024",3,3,0,0,100,294863,1996,143
"33500","2024",1,1,0,0,100,250667,1393,180
"33501","2024",28,27,1,4,96,308934,3076,106
"33502","2024",3,3,0,0,100,169000,1751,90
"33503","2024",4,4,0,0,100,300082,3002,100
"33504","2024",5,5,0,0,100,225601,2491,93
"33505","2024",6,6,0,0,100,204406,2205,97
"33506","2024",14,14,0,0,100,191335,1449,134
"33507","2024",3,3,0,0,100,199267,1761,112
"33508","2024",9,9,0,0,100,264833,2113,129
"33509","2024",6,6,0,0,100,315477,2308,130
"33511","2024",6,6,0,0,100,198604,2324,108
"33512","2024",5,5,0,0,100,154806,1455,110
"33513","2024",2,2,0,0,100,72500,1117,66
"33514","2024",95,53,42,44,56,259052,4322,64
"33515","2024",1,1,0,0,100,210000,2258,93
"33516","2024",4,4,0,0,100,171065,1408,103
"33517","2024",17,17,0,0,100,268681,2378,112
"33518","2024",2,2,0,0,100,437500,3997,120
"33519","2024",99,77,22,22,78,312512,3480,92
"33520","2024",2,2,0,0,100,153500,1182,158
"33521","2024",9,9,0,0,100,249985,2464,96
"33522","2024",526,179,347,66,34,248522,4036,63
"33523","2024",14,14,0,0,100,229813,2059,116
"33524","2024",3,3,0,0,100,299017,3014,103
"33525","2024",14,14,0,0,100,226858,2336,102
"33527","2024",101,71,30,30,70,347047,4329,84
"33528","2024",4,2,2,50,50,308975,2448,122
"33529","2024",360,234,126,35,65,555405,6104,86
"33530","2024",6,6,0,0,100,203142,2050,97
"33531","2024",1,1,0,0,100,230000,2556,90
"33532","2024",3,3,0,0,100,259367,2166,135
"33533","2024",35,33,2,6,94,190654,2452,81
"33534","2024",8,8,0,0,100,169752,2318,91
"33535","2024",35,34,1,3,97,357120,3196,112
"33536","2024",3,3,0,0,100,226943,2457,93
"33537","2024",2,2,0,0,100,188652,2188,106
"33538","2024",10,10,0,0,100,204340,1483,130
"33539","2024",37,30,7,19,81,231142,2375,98
"33540","2024",48,47,1,2,98,286925,3825,81
"33541","2024",8,8,0,0,100,204989,2522,82
"33542","2024",6,6,0,0,100,193559,1989,106
"33543","2024",10,10,0,0,100,223695,2205,101
"33544","2024",60,34,26,43,57,180584,2845,65
"33545","2024",18,18,0,0,100,170426,2404,87
"33546","2024",2,2,0,0,100,165000,1619,101
"33547","2024",11,10,1,9,91,200336,1839,111
"33548","2024",5,4,1,20,80,270270,3022,108
"33549","2024",4,3,1,25,75,178075,1701,102
"33550","2024",413,217,196,47,53,255187,3456,75
"33551","2024",3,3,0,0,100,283867,1853,161
"33552","2024",10,10,0,0,100,224476,2444,108
"33553","2024",6,6,0,0,100,276277,2712,106
"33554","2024",24,21,3,12,88,278770,3011,94
"33555","2024",46,36,10,22,78,295629,3342,89
